Rk,Season,Team,G,W,L,W/L%,MP,FG,FGA,2P,2PA,3P,3PA,FT,FTA,ORB,DRB,TRB,AST,STL,BLK,TOV,PF,PTS,FG%,2P%,3P%,FT%,TS%,eFG%
1,2023-24,Youngstown State,32,22,10,0.688,6450,931,2064,649,1192,282,872,454,589,409,870,1279,490,198,156,353,520,2598,0.451,0.544,0.323,0.771,0.554,0.519
2,2022-23,Youngstown State,34,24,10,0.706,6925,1017,2088,746,1345,271,743,480,616,351,853,1204,521,238,94,376,550,2785,0.487,0.555,0.365,0.779,0.585,0.552
3,2021-22,Youngstown State,34,19,15,0.559,6825,878,1960,622,1214,256,746,458,602,346,833,1179,403,183,87,398,593,2470,0.448,0.512,0.343,0.761,0.55,0.513
4,2020-21,Youngstown State,27,15,12,0.556,5475,717,1672,531,1066,186,606,390,537,346,645,991,349,163,44,310,441,2010,0.429,0.498,0.307,0.726,0.522,0.484
5,2019-20,Youngstown State,33,18,15,0.545,6675,870,2055,634,1290,236,765,425,616,451,835,1286,413,188,85,397,579,2401,0.423,0.491,0.308,0.69,0.511,0.481
6,2023-24,Yale,33,23,10,0.697,6700,919,1969,678,1282,241,687,386,546,326,879,1205,495,204,105,316,499,2465,0.467,0.529,0.351,0.707,0.553,0.528
7,2022-23,Yale,30,21,9,0.7,6050,841,1764,617,1144,224,620,367,529,298,835,1133,439,191,123,335,521,2273,0.477,0.539,0.361,0.694,0.564,0.54
8,2021-22,Yale,31,19,12,0.613,6225,795,1800,583,1153,212,647,424,577,278,834,1112,371,193,98,398,543,2226,0.442,0.506,0.328,0.735,0.537,0.501
9,2019-20,Yale,30,23,7,0.767,6200,809,1726,544,1012,265,714,406,570,273,893,1166,464,188,101,389,449,2289,0.469,0.538,0.371,0.712,0.573,0.545
10,2023-24,Xavier,34,16,18,0.471,6800,923,2116,691,1438,232,678,501,672,401,896,1297,551,236,115,396,572,2579,0.436,0.481,0.342,0.746,0.53,0.491
11,2022-23,Xavier,37,27,10,0.73,7425,1109,2256,835,1553,274,703,503,708,380,1016,1396,705,236,120,459,593,2995,0.492,0.538,0.39,0.71,0.578,0.552
12,2021-22,Xavier,36,23,13,0.639,7300,953,2112,711,1361,242,751,520,745,372,963,1335,533,269,156,420,553,2668,0.451,0.522,0.322,0.698,0.541,0.509
13,2020-21,Xavier,21,13,8,0.619,4250,589,1285,427,787,162,498,231,333,200,592,792,369,145,85,235,325,1571,0.458,0.543,0.325,0.694,0.544,0.521
14,2019-20,Xavier,32,19,13,0.594,6525,833,1912,626,1248,207,664,388,590,380,861,1241,460,201,114,446,535,2261,0.436,0.502,0.312,0.658,0.516,0.49
15,2023-24,Wyoming,32,15,17,0.469,6450,791,1755,550,1107,241,648,508,686,307,796,1103,374,165,80,408,500,2331,0.451,0.497,0.372,0.741,0.56,0.519
16,2022-23,Wyoming,31,9,22,0.29,6225,740,1680,472,912,268,768,396,557,246,748,994,345,151,79,371,488,2144,0.44,0.518,0.349,0.711,0.551,0.52
17,2021-22,Wyoming,34,25,9,0.735,6900,853,1865,578,1061,275,804,485,669,280,932,1212,381,133,67,385,516,2466,0.457,0.545,0.342,0.725,0.565,0.531
18,2020-21,Wyoming,25,14,11,0.56,5050,649,1442,398,738,251,704,366,509,203,613,816,351,145,54,281,468,1915,0.45,0.539,0.357,0.719,0.569,0.537
19,2019-20,Wyoming,33,9,24,0.273,6675,712,1739,452,930,260,809,386,531,161,811,972,374,175,66,418,626,2070,0.409,0.486,0.321,0.727,0.52,0.484
20,2023-24,Wright State,32,18,14,0.563,6475,1033,1948,815,1379,218,569,483,638,290,821,1111,529,200,90,379,499,2767,0.53,0.591,0.383,0.757,0.615,0.586
21,2022-23,Wright State,33,18,15,0.545,6750,1031,2077,826,1503,205,574,370,502,304,908,1212,495,207,99,419,514,2637,0.496,0.55,0.357,0.737,0.569,0.546
22,2021-22,Wright State,36,22,14,0.611,7200,987,2140,754,1440,233,700,522,680,377,878,1255,506,212,107,440,523,2729,0.461,0.524,0.333,0.768,0.554,0.516
23,2020-21,Wright State,24,18,6,0.75,4825,710,1471,531,987,179,484,368,508,284,731,1015,369,142,87,314,328,1967,0.483,0.538,0.37,0.724,0.574,0.544
24,2019-20,Wright State,32,25,7,0.781,6475,917,2010,670,1326,247,684,499,741,388,891,1279,443,209,113,396,516,2580,0.456,0.505,0.361,0.673,0.546,0.518
25,2023-24,Wofford,32,17,15,0.531,6499,874,1905,568,1053,306,852,330,532,337,853,1190,494,142,86,373,522,2384,0.459,0.539,0.359,0.62,0.552,0.539
26,2022-23,Wofford,33,17,16,0.515,6700,906,1916,659,1168,247,748,407,552,312,776,1088,412,188,68,361,468,2466,0.473,0.564,0.33,0.737,0.566,0.537
27,2021-22,Wofford,32,19,13,0.594,6425,818,1758,515,906,303,852,383,505,271,726,997,425,222,47,372,486,2322,0.465,0.568,0.356,0.758,0.581,0.551
28,2020-21,Wofford,24,15,9,0.625,4825,646,1374,400,682,246,692,246,349,216,613,829,351,160,48,306,380,1784,0.47,0.587,0.355,0.705,0.579,0.56
29,2019-20,Wofford,35,19,16,0.543,7075,909,1969,573,1021,336,948,369,518,272,822,1094,467,198,91,424,593,2523,0.462,0.561,0.354,0.712,0.57,0.547
30,2023-24,Wisconsin,36,22,14,0.611,7275,952,2067,696,1333,256,734,528,699,362,862,1224,458,224,59,358,594,2688,0.461,0.522,0.349,0.755,0.56,0.522
31,2022-23,Wisconsin,35,20,15,0.571,7150,831,2005,555,1198,276,807,346,501,278,832,1110,406,207,52,302,554,2284,0.414,0.463,0.342,0.691,0.509,0.483
32,2021-22,Wisconsin,33,25,8,0.758,6600,815,1931,602,1235,213,696,465,626,308,848,1156,365,175,97,287,554,2308,0.422,0.487,0.306,0.743,0.518,0.477
33,2020-21,Wisconsin,31,18,13,0.581,6250,767,1806,498,1068,269,738,364,474,255,787,1042,414,175,123,280,500,2167,0.425,0.466,0.364,0.768,0.533,0.499
34,2019-20,Wisconsin,31,21,10,0.677,6225,730,1718,461,954,269,764,353,462,251,800,1051,373,138,114,309,476,2082,0.425,0.483,0.352,0.764,0.537,0.503
35,2023-24,Winthrop,32,17,15,0.531,6550,818,1763,580,1066,238,697,601,856,341,793,1134,380,201,89,415,570,2475,0.464,0.544,0.341,0.702,0.57,0.531
36,2022-23,Winthrop,32,15,17,0.469,6425,787,1671,504,914,283,757,503,681,260,733,993,366,164,98,447,538,2360,0.471,0.551,0.374,0.739,0.592,0.556
37,2021-22,Winthrop,32,23,9,0.719,6475,842,1733,566,990,276,743,447,639,264,833,1097,428,207,83,467,572,2407,0.486,0.572,0.371,0.7,0.591,0.565
38,2020-21,Winthrop,25,23,2,0.92,5000,695,1521,485,924,210,597,372,541,321,682,1003,374,186,57,350,459,1972,0.457,0.525,0.352,0.688,0.555,0.526
39,2019-20,Winthrop,34,24,10,0.706,6875,980,2120,658,1189,322,931,483,760,450,938,1388,542,225,84,471,683,2765,0.462,0.553,0.346,0.636,0.557,0.538
40,2023-24,William & Mary,33,10,23,0.303,6625,787,1910,491,994,296,916,435,620,341,820,1161,407,156,56,357,560,2305,0.412,0.494,0.323,0.702,0.523,0.49
41,2022-23,William & Mary,33,13,20,0.394,6625,791,1829,535,1131,256,698,381,559,330,765,1095,401,199,67,398,533,2219,0.432,0.473,0.367,0.682,0.53,0.502
42,2021-22,William & Mary,32,5,27,0.156,6475,724,1799,508,1097,216,702,380,539,312,817,1129,367,211,95,519,537,2044,0.402,0.463,0.308,0.705,0.497,0.462
43,2020-21,William & Mary,17,7,10,0.412,3425,388,948,290,606,98,342,227,303,170,404,574,183,90,56,232,265,1101,0.409,0.479,0.287,0.749,0.504,0.461
44,2019-20,William & Mary,32,21,11,0.656,6400,822,1770,583,1080,239,690,405,544,265,887,1152,435,138,128,403,500,2288,0.464,0.54,0.346,0.744,0.564,0.532
45,2023-24,Wichita State,34,15,19,0.441,6850,935,2091,715,1431,220,660,385,552,396,943,1339,413,213,142,419,522,2475,0.447,0.5,0.333,0.697,0.526,0.5
46,2022-23,Wichita State,32,17,15,0.531,6500,827,1839,615,1154,212,685,406,567,312,851,1163,426,203,129,401,478,2272,0.45,0.533,0.309,0.716,0.539,0.507
47,2021-22,Wichita State,28,15,13,0.536,5675,658,1634,447,957,211,677,390,518,333,705,1038,336,211,128,360,446,1917,0.403,0.467,0.312,0.753,0.51,0.467
48,2020-21,Wichita State,22,16,6,0.727,4450,533,1317,355,787,178,530,328,482,261,573,834,286,135,82,246,342,1572,0.405,0.451,0.336,0.68,0.508,0.472
49,2019-20,Wichita State,31,23,8,0.742,6250,769,1891,525,1147,244,744,445,638,374,844,1218,437,219,115,396,577,2227,0.407,0.458,0.328,0.697,0.508,0.471
50,2023-24,Western Michigan,32,12,20,0.375,6475,828,1912,575,1165,253,747,372,595,402,810,1212,418,169,87,428,550,2281,0.433,0.494,0.339,0.625,0.52,0.499
51,2022-23,Western Michigan,31,8,23,0.258,6200,786,1820,536,1063,250,757,344,482,379,767,1146,396,143,68,395,522,2166,0.432,0.504,0.33,0.714,0.529,0.501
52,2021-22,Western Michigan,31,8,23,0.258,6275,730,1736,468,948,262,788,305,436,283,743,1026,319,165,72,425,522,2027,0.421,0.494,0.332,0.7,0.522,0.496
53,2020-21,Western Michigan,21,5,16,0.238,4200,499,1153,358,726,141,427,186,291,167,543,710,245,93,42,305,346,1325,0.433,0.493,0.33,0.639,0.513,0.494
54,2019-20,Western Michigan,32,13,19,0.406,6475,767,1791,539,1115,228,676,458,641,276,844,1120,356,152,73,416,573,2220,0.428,0.483,0.337,0.715,0.53,0.492
55,2023-24,Western Kentucky,34,22,12,0.647,6806,996,2138,763,1452,233,686,503,699,361,997,1358,454,260,110,470,625,2728,0.466,0.525,0.34,0.72,0.552,0.52
56,2022-23,Western Kentucky,33,17,16,0.515,6650,839,1907,590,1212,249,695,428,601,300,852,1152,416,204,173,383,489,2355,0.44,0.487,0.358,0.712,0.537,0.505
57,2021-22,Western Kentucky,32,19,13,0.594,6400,881,1885,635,1190,246,695,406,569,271,861,1132,445,271,190,388,362,2414,0.467,0.534,0.354,0.714,0.56,0.533
58,2020-21,Western Kentucky,29,21,8,0.724,5850,733,1634,548,1098,185,536,457,580,305,788,1093,395,187,134,413,410,2108,0.449,0.499,0.345,0.788,0.552,0.505
59,2019-20,Western Kentucky,30,20,10,0.667,6125,779,1703,567,1076,212,627,527,668,252,761,1013,334,201,119,370,413,2297,0.457,0.527,0.338,0.789,0.568,0.52
60,2023-24,Western Illinois,33,21,12,0.636,6650,826,1936,631,1325,195,611,425,691,482,915,1397,421,173,185,436,470,2272,0.427,0.476,0.319,0.615,0.502,0.477
61,2022-23,Western Illinois,30,16,14,0.533,6025,795,1755,586,1103,209,652,392,560,284,750,1034,410,174,107,322,434,2191,0.453,0.531,0.321,0.7,0.542,0.513
62,2021-22,Western Illinois,32,16,16,0.5,6500,889,2048,612,1211,277,837,438,619,361,851,1212,365,199,81,365,558,2493,0.434,0.505,0.331,0.708,0.532,0.502
63,2020-21,Western Illinois,22,7,15,0.318,4400,550,1362,393,865,157,497,349,488,258,580,838,225,116,67,286,444,1606,0.404,0.454,0.316,0.715,0.504,0.461
64,2019-20,Western Illinois,26,5,21,0.192,5250,710,1667,484,1055,226,612,288,368,216,666,882,267,129,57,290,467,1934,0.426,0.459,0.369,0.783,0.525,0.494
65,2023-24,Western Carolina,32,22,10,0.688,6475,902,1963,641,1250,261,713,394,553,335,934,1269,367,141,103,330,536,2459,0.46,0.513,0.366,0.712,0.552,0.526
66,2022-23,Western Carolina,34,18,16,0.529,6925,871,2015,582,1166,289,849,482,674,335,921,1256,428,183,88,365,588,2513,0.432,0.499,0.34,0.715,0.538,0.504
67,2021-22,Western Carolina,32,11,21,0.344,6475,787,1960,467,958,320,1002,367,545,367,834,1201,412,156,76,397,544,2261,0.402,0.487,0.319,0.673,0.509,0.483
68,2020-21,Western Carolina,27,11,16,0.407,5525,716,1577,490,915,226,662,381,525,211,717,928,359,133,75,382,455,2039,0.454,0.536,0.341,0.726,0.558,0.526
69,2019-20,Western Carolina,31,19,12,0.613,6250,837,1790,535,972,302,818,468,659,302,863,1165,449,165,56,445,532,2444,0.468,0.55,0.369,0.71,0.581,0.552
70,2023-24,West Virginia,32,9,23,0.281,6450,767,1784,534,1117,233,667,467,662,293,787,1080,417,139,114,405,487,2234,0.43,0.478,0.349,0.705,0.532,0.495
71,2022-23,West Virginia,34,19,15,0.559,6825,882,1953,634,1245,248,708,571,769,383,769,1152,442,227,104,440,632,2583,0.452,0.509,0.35,0.743,0.557,0.515
72,2021-22,West Virginia,33,16,17,0.485,6600,779,1885,571,1250,208,635,493,681,355,709,1064,346,257,150,410,575,2259,0.413,0.457,0.328,0.724,0.511,0.468
73,2020-21,West Virginia,29,19,10,0.655,5875,769,1793,553,1200,216,593,489,680,389,708,1097,407,220,82,348,473,2243,0.429,0.461,0.364,0.719,0.53,0.489
74,2019-20,West Virginia,31,21,10,0.677,6225,774,1833,619,1291,155,542,476,742,470,784,1254,383,238,111,447,572,2179,0.422,0.479,0.286,0.642,0.499,0.465
75,2023-24,Weber State,32,20,12,0.625,6450,843,1797,592,1076,251,721,477,637,248,777,1025,390,221,53,316,495,2414,0.469,0.55,0.348,0.749,0.575,0.539
76,2022-23,Weber State,33,18,15,0.545,6725,779,1727,561,1080,218,647,443,578,218,814,1032,351,200,47,422,580,2219,0.451,0.519,0.337,0.766,0.554,0.514
77,2021-22,Weber State,33,21,12,0.636,6625,878,1847,642,1151,236,696,521,696,217,841,1058,351,253,83,384,507,2513,0.475,0.558,0.339,0.749,0.577,0.539
78,2020-21,Weber State,23,17,6,0.739,4600,656,1300,463,804,193,496,376,478,148,606,754,345,154,69,288,376,1881,0.505,0.576,0.389,0.787,0.616,0.579
79,2019-20,Weber State,32,12,20,0.375,6450,821,1814,608,1153,213,661,370,510,232,791,1023,347,164,125,378,453,2225,0.453,0.527,0.322,0.725,0.541,0.511
80,2023-24,Washington State,35,25,10,0.714,7050,948,2046,725,1388,223,658,455,646,391,926,1317,435,181,172,383,582,2574,0.463,0.522,0.339,0.704,0.547,0.518
81,2022-23,Washington State,34,17,17,0.5,6825,813,1919,503,1087,310,832,388,542,369,814,1183,403,166,93,408,544,2324,0.424,0.463,0.373,0.716,0.534,0.504
82,2021-22,Washington State,37,22,15,0.595,7425,908,2239,577,1250,331,989,497,668,462,915,1377,416,237,165,416,644,2644,0.406,0.462,0.335,0.744,0.517,0.479
83,2020-21,Washington State,27,14,13,0.519,5550,633,1539,425,929,208,610,379,534,304,723,1027,328,167,95,412,496,1853,0.411,0.457,0.341,0.71,0.517,0.479
84,2019-20,Washington State,32,16,16,0.5,6450,776,1952,539,1184,237,768,446,600,344,821,1165,370,218,85,394,562,2235,0.398,0.455,0.309,0.743,0.5,0.458
85,2023-24,Washington,32,17,15,0.531,6525,931,1980,673,1252,258,728,459,636,301,850,1151,482,184,118,374,585,2579,0.47,0.538,0.354,0.722,0.565,0.535
86,2022-23,Washington,32,16,16,0.5,6500,786,1823,577,1155,209,668,432,577,286,797,1083,368,220,165,448,529,2213,0.431,0.5,0.313,0.749,0.528,0.488
87,2021-22,Washington,32,17,15,0.531,6475,796,1929,598,1295,198,634,470,670,352,717,1069,326,265,132,381,532,2260,0.413,0.462,0.312,0.701,0.503,0.464
88,2020-21,Washington,26,5,21,0.192,5200,641,1513,444,920,197,593,280,397,213,598,811,280,158,95,355,472,1759,0.424,0.483,0.332,0.705,0.517,0.489
89,2019-20,Washington,32,15,17,0.469,6450,778,1763,558,1086,220,677,483,669,282,846,1128,399,236,192,481,555,2259,0.441,0.514,0.325,0.722,0.543,0.504
90,2023-24,Wake Forest,35,21,14,0.6,7050,968,2042,690,1278,278,764,519,653,296,901,1197,429,207,145,375,542,2733,0.474,0.54,0.364,0.795,0.581,0.542
91,2022-23,Wake Forest,33,19,14,0.576,6650,878,1909,563,1043,315,866,457,613,275,854,1129,444,199,90,399,528,2528,0.46,0.54,0.364,0.746,0.574,0.542
92,2021-22,Wake Forest,35,25,10,0.714,7100,978,2026,682,1166,296,860,497,681,305,982,1287,527,227,136,488,559,2749,0.483,0.585,0.344,0.73,0.585,0.556
93,2020-21,Wake Forest,22,6,16,0.273,4425,501,1222,306,660,195,562,261,359,198,520,718,252,136,48,300,365,1458,0.41,0.464,0.347,0.727,0.524,0.49
94,2019-20,Wake Forest,31,13,18,0.419,6300,765,1769,561,1187,204,582,542,726,315,855,1170,395,151,87,440,592,2276,0.432,0.473,0.351,0.747,0.538,0.49
95,2023-24,Wagner,33,17,16,0.515,6675,758,1913,520,1186,238,727,349,496,369,814,1183,421,195,76,326,507,2103,0.396,0.438,0.327,0.704,0.489,0.458
96,2022-23,Wagner,28,15,13,0.536,5650,655,1627,474,1044,181,583,275,403,360,645,1005,339,189,49,335,540,1766,0.403,0.454,0.31,0.682,0.486,0.458
97,2021-22,Wagner,27,21,6,0.778,5500,747,1613,609,1129,138,484,378,521,318,688,1006,393,226,76,338,535,2010,0.463,0.539,0.285,0.726,0.54,0.506
98,2020-21,Wagner,20,13,7,0.65,4075,533,1205,416,837,117,368,242,337,247,466,713,258,147,51,246,406,1425,0.442,0.497,0.318,0.718,0.522,0.491
99,2019-20,Wagner,29,8,21,0.276,5875,706,1710,502,1066,204,644,366,504,312,671,983,374,174,68,398,604,1982,0.413,0.471,0.317,0.726,0.508,0.473
100,2023-24,VMI,32,4,28,0.125,6425,818,1935,608,1262,210,673,358,517,299,871,1170,335,179,82,507,539,2204,0.423,0.482,0.312,0.692,0.505,0.477
101,2022-23,VMI,32,7,25,0.219,6450,800,1923,491,1043,309,880,311,406,349,782,1131,365,172,37,411,484,2220,0.416,0.471,0.351,0.766,0.525,0.496
102,2021-22,VMI,32,16,16,0.5,6475,876,1907,476,858,400,1049,377,476,264,898,1162,511,154,87,370,477,2529,0.459,0.555,0.381,0.792,0.593,0.564
103,2020-21,VMI,25,13,12,0.52,5050,706,1517,436,806,270,711,319,413,203,760,963,393,134,75,314,364,2001,0.465,0.541,0.38,0.772,0.584,0.554
104,2019-20,VMI,33,9,24,0.273,6700,852,1991,493,979,359,1012,317,448,334,846,1180,528,222,83,418,591,2380,0.428,0.504,0.355,0.708,0.54,0.518
105,2023-24,Virginia Tech,34,19,15,0.559,6800,886,1905,610,1113,276,792,499,629,263,838,1101,514,180,83,376,540,2547,0.465,0.548,0.348,0.793,0.578,0.538
106,2022-23,Virginia Tech,34,19,15,0.559,6825,931,1983,650,1197,281,786,378,514,288,843,1131,528,177,107,336,526,2521,0.469,0.543,0.358,0.735,0.566,0.54
107,2021-22,Virginia Tech,36,23,13,0.639,7225,933,1981,614,1167,319,814,364,485,305,847,1152,515,192,114,391,535,2549,0.471,0.526,0.392,0.751,0.576,0.551
108,2020-21,Virginia Tech,22,15,7,0.682,4475,558,1240,378,732,180,508,289,414,204,556,760,313,106,85,256,362,1585,0.45,0.516,0.354,0.698,0.552,0.523
109,2019-20,Virginia Tech,32,16,16,0.5,6550,787,1877,472,981,315,896,305,429,240,846,1086,468,193,95,317,472,2194,0.419,0.481,0.352,0.711,0.527,0.503
110,2023-24,Virginia,34,23,11,0.676,6875,808,1887,588,1272,220,615,304,477,298,809,1107,509,239,169,274,460,2140,0.428,0.462,0.358,0.637,0.506,0.486
111,2022-23,Virginia,33,25,8,0.758,6625,793,1765,573,1136,220,629,431,613,273,791,1064,519,225,142,282,471,2237,0.449,0.504,0.35,0.703,0.544,0.512
112,2021-22,Virginia,35,21,14,0.6,7025,817,1820,641,1275,176,545,374,512,300,797,1097,493,200,149,339,480,2184,0.449,0.503,0.323,0.73,0.529,0.497
113,2020-21,Virginia,25,18,7,0.72,5025,629,1326,417,760,212,566,235,288,162,629,791,345,123,111,229,323,1705,0.474,0.549,0.375,0.816,0.583,0.554
114,2019-20,Virginia,30,23,7,0.767,6075,626,1515,456,955,170,560,289,403,243,782,1025,343,161,147,368,397,1711,0.413,0.477,0.304,0.717,0.501,0.469
115,2023-24,Villanova,34,18,16,0.529,6950,826,1945,511,1012,315,933,421,521,288,896,1184,437,197,81,327,520,2388,0.425,0.505,0.338,0.808,0.545,0.506
116,2022-23,Villanova,34,17,17,0.5,6825,807,1853,511,968,296,885,456,556,246,832,1078,377,194,58,343,538,2366,0.436,0.528,0.334,0.82,0.559,0.515
117,2021-22,Villanova,38,30,8,0.789,7625,922,2133,567,1145,355,988,527,635,392,930,1322,451,229,83,376,566,2726,0.432,0.495,0.359,0.83,0.56,0.515
118,2020-21,Villanova,25,18,7,0.72,5025,655,1446,426,798,229,648,331,434,232,615,847,374,127,47,227,387,1870,0.453,0.534,0.353,0.763,0.566,0.532
119,2019-20,Villanova,31,24,7,0.774,6225,797,1806,490,952,307,854,368,485,271,841,1112,449,175,81,335,471,2269,0.441,0.515,0.359,0.759,0.557,0.526
120,2023-24,Vermont,35,28,7,0.8,7025,900,1980,600,1102,300,878,406,567,268,944,1212,478,206,136,322,488,2506,0.455,0.544,0.342,0.716,0.557,0.53
121,2022-23,Vermont,34,23,11,0.676,6885,901,1901,609,1085,292,816,377,541,220,845,1065,465,200,98,318,504,2471,0.474,0.561,0.358,0.697,0.573,0.551
122,2021-22,Vermont,34,28,6,0.824,6825,936,1902,638,1085,298,817,374,504,248,943,1191,515,173,84,326,475,2544,0.492,0.588,0.365,0.742,0.594,0.57
123,2020-21,Vermont,15,10,5,0.667,3050,383,828,267,491,116,337,213,273,126,398,524,211,75,39,183,266,1095,0.463,0.544,0.344,0.78,0.572,0.533
124,2019-20,Vermont,33,26,7,0.788,6600,841,1876,574,1060,267,816,412,574,313,899,1212,456,194,111,371,534,2361,0.448,0.542,0.327,0.718,0.549,0.519
125,2023-24,VCU,38,24,14,0.632,7650,906,2059,584,1148,322,911,563,721,343,993,1336,515,246,167,462,625,2697,0.44,0.509,0.353,0.781,0.562,0.518
126,2022-23,VCU,35,27,8,0.771,7000,864,1867,652,1257,212,610,540,776,324,837,1161,456,311,160,468,575,2480,0.463,0.519,0.348,0.696,0.555,0.52
127,2021-22,VCU,32,22,10,0.688,6425,795,1723,614,1202,181,521,375,533,268,772,1040,446,294,162,483,599,2146,0.461,0.511,0.347,0.704,0.543,0.514
128,2020-21,VCU,27,19,7,0.731,5425,659,1460,491,950,168,510,378,497,238,652,890,347,240,140,380,485,1864,0.451,0.517,0.329,0.761,0.55,0.509
129,2019-20,VCU,31,18,13,0.581,6225,775,1792,544,1125,231,667,412,592,306,733,1039,409,278,134,384,569,2193,0.432,0.484,0.346,0.696,0.529,0.497
130,2023-24,Vanderbilt,32,9,23,0.281,6425,748,1877,539,1139,209,738,468,660,344,758,1102,300,196,92,333,489,2173,0.399,0.473,0.283,0.709,0.496,0.454
131,2022-23,Vanderbilt,37,22,15,0.595,7450,930,2187,620,1265,310,922,491,690,417,923,1340,429,187,168,399,604,2661,0.425,0.49,0.336,0.712,0.529,0.496
132,2021-22,Vanderbilt,36,19,17,0.528,7250,849,2001,539,1088,310,913,540,775,347,888,1235,423,261,122,472,650,2548,0.424,0.495,0.34,0.697,0.538,0.502
133,2020-21,Vanderbilt,25,9,16,0.36,5000,609,1416,376,749,233,667,343,466,246,597,843,318,175,65,346,440,1794,0.43,0.502,0.349,0.736,0.548,0.512
134,2019-20,Vanderbilt,32,11,21,0.344,6450,760,1776,498,990,262,786,513,736,288,747,1035,365,226,104,418,614,2295,0.428,0.503,0.333,0.697,0.54,0.502
135,2023-24,Valparaiso,32,7,25,0.219,6400,796,1961,562,1240,234,721,337,471,320,744,1064,384,197,113,353,521,2163,0.406,0.453,0.325,0.715,0.495,0.466
136,2022-23,Valparaiso,32,11,21,0.344,6550,814,1852,616,1184,198,668,380,522,251,836,1087,436,187,83,406,530,2206,0.44,0.52,0.296,0.728,0.525,0.493
137,2021-22,Valparaiso,32,14,18,0.438,6600,836,1820,606,1128,230,692,362,477,174,860,1034,400,204,95,354,431,2264,0.459,0.537,0.332,0.759,0.553,0.523
138,2020-21,Valparaiso,28,10,18,0.357,5650,660,1576,471,941,189,635,312,429,196,724,920,356,183,97,346,445,1821,0.419,0.501,0.298,0.727,0.512,0.479
139,2019-20,Valparaiso,35,19,16,0.543,7100,922,2088,635,1245,287,843,399,559,329,867,1196,533,269,116,446,601,2530,0.442,0.51,0.34,0.714,0.537,0.51
140,2023-24,UTSA,32,11,21,0.344,6500,837,2040,526,1118,311,922,498,701,419,870,1289,444,161,133,360,573,2483,0.41,0.47,0.337,0.71,0.523,0.487
141,2022-23,UTSA,32,10,22,0.313,6454,749,1826,514,1123,235,703,484,659,341,791,1132,334,137,81,439,563,2217,0.41,0.458,0.334,0.734,0.518,0.475
142,2021-22,UTSA,32,10,22,0.313,6425,795,2010,595,1330,200,680,363,532,406,820,1226,366,183,81,406,525,2153,0.396,0.447,0.294,0.682,0.476,0.445
143,2020-21,UTSA,26,15,11,0.577,5200,768,1717,559,1092,209,625,305,401,300,701,1001,383,161,83,302,475,2050,0.447,0.512,0.334,0.761,0.537,0.508
144,2019-20,UTSA,32,13,19,0.406,6500,866,2076,558,1195,308,881,421,552,352,896,1248,398,189,86,413,644,2461,0.417,0.467,0.35,0.763,0.526,0.491
145,2023-24,UTEP,34,18,16,0.529,6850,859,1922,665,1313,194,609,558,809,361,763,1124,439,389,97,500,677,2470,0.447,0.506,0.319,0.69,0.535,0.497
146,2022-23,UTEP,32,14,18,0.438,6575,796,1776,638,1239,158,537,442,699,373,749,1122,385,288,85,505,576,2192,0.448,0.515,0.294,0.632,0.52,0.493
147,2021-22,UTEP,34,20,14,0.588,6850,840,1950,581,1209,259,741,413,541,275,818,1093,412,253,121,396,617,2352,0.431,0.481,0.35,0.763,0.533,0.497
148,2020-21,UTEP,24,12,12,0.5,4825,608,1432,437,908,171,524,311,416,210,618,828,285,150,67,262,421,1698,0.425,0.481,0.326,0.748,0.521,0.484
149,2019-20,UTEP,32,17,15,0.531,6425,747,1765,535,1060,212,705,451,602,267,849,1116,404,194,102,438,561,2157,0.423,0.505,0.301,0.749,0.526,0.483
150,2023-24,Utah Valley,32,16,16,0.5,6450,801,1851,647,1311,154,540,443,655,335,844,1179,477,222,143,395,578,2199,0.433,0.494,0.285,0.676,0.509,0.474
151,2022-23,Utah Valley,37,28,9,0.757,7502,1022,2200,780,1472,242,728,577,780,377,1115,1492,594,239,242,509,646,2863,0.465,0.53,0.332,0.74,0.557,0.52
152,2021-22,Utah Valley,32,20,12,0.625,6525,798,1758,594,1207,204,551,479,671,349,946,1295,475,175,143,495,539,2279,0.454,0.492,0.37,0.714,0.549,0.512
153,2020-21,Utah Valley,22,11,11,0.5,4425,592,1246,476,911,116,335,332,526,239,615,854,370,115,101,329,431,1632,0.475,0.523,0.346,0.631,0.546,0.522
154,2019-20,Utah Valley,30,11,19,0.367,6050,748,1696,556,1061,192,635,417,585,253,804,1057,412,173,157,427,534,2105,0.441,0.524,0.302,0.713,0.533,0.498
155,2023-24,Utah Tech,31,11,20,0.355,6250,771,1724,570,1128,201,596,451,699,307,763,1070,401,205,133,495,647,2194,0.447,0.505,0.337,0.645,0.534,0.506
156,2022-23,Utah Tech,33,14,19,0.424,6650,828,1802,543,1053,285,749,554,787,321,804,1125,434,219,74,497,647,2495,0.459,0.516,0.381,0.704,0.573,0.539
157,2023-24,Utah State,35,28,7,0.8,7100,999,2036,773,1358,226,678,564,783,332,922,1254,572,238,148,385,594,2788,0.491,0.569,0.333,0.72,0.579,0.546
158,2022-23,Utah State,35,26,9,0.743,7025,947,1975,622,1135,325,840,517,678,300,943,1243,585,175,117,426,589,2736,0.479,0.548,0.387,0.763,0.596,0.562
159,2021-22,Utah State,34,18,16,0.529,6900,917,1926,652,1151,265,775,398,552,286,917,1203,611,209,72,424,560,2497,0.476,0.566,0.342,0.721,0.571,0.545
160,2020-21,Utah State,29,20,9,0.69,5800,773,1732,588,1175,185,557,374,518,361,819,1180,469,193,145,403,436,2105,0.446,0.5,0.332,0.722,0.532,0.5
161,2019-20,Utah State,34,26,8,0.765,6875,905,1967,657,1222,248,745,542,710,366,1019,1385,561,209,109,426,532,2600,0.46,0.538,0.333,0.763,0.564,0.523
162,2023-24,Utah,37,22,15,0.595,7475,1082,2309,737,1376,345,933,406,625,370,1068,1438,654,217,154,426,587,2915,0.469,0.536,0.37,0.65,0.559,0.543
163,2022-23,Utah,32,17,15,0.531,6425,791,1852,559,1154,232,698,383,541,357,897,1254,462,161,126,384,487,2197,0.427,0.484,0.332,0.708,0.521,0.49
164,2021-22,Utah,31,11,20,0.355,6250,753,1799,516,1091,237,708,418,540,326,799,1125,418,142,90,380,511,2161,0.419,0.473,0.335,0.774,0.526,0.484
165,2020-21,Utah,25,12,13,0.48,5050,656,1398,484,914,172,484,319,403,185,597,782,378,136,85,314,419,1803,0.469,0.53,0.355,0.792,0.567,0.531
166,2019-20,Utah,31,16,15,0.516,6300,767,1709,548,1054,219,655,446,611,295,811,1106,433,170,86,419,479,2199,0.449,0.52,0.334,0.73,0.55,0.513
167,2023-24,UT Martin,32,21,11,0.656,6450,908,2045,629,1266,279,779,514,667,325,994,1319,415,199,89,366,455,2609,0.444,0.497,0.358,0.771,0.552,0.512
168,2022-23,UT Martin,33,19,14,0.576,6675,945,2058,690,1287,255,771,513,711,346,947,1293,450,249,114,394,603,2658,0.459,0.536,0.331,0.722,0.555,0.521
169,2021-22,UT Martin,30,8,22,0.267,6000,762,1837,557,1152,205,685,338,483,350,756,1106,353,198,131,400,543,2067,0.415,0.484,0.299,0.7,0.5,0.471
170,2020-21,UT Martin,24,8,16,0.333,4850,556,1393,391,898,165,495,294,409,260,515,775,289,172,62,343,429,1571,0.399,0.435,0.333,0.719,0.495,0.458
171,2019-20,UT Martin,29,9,20,0.31,5825,781,1718,563,1072,218,646,414,550,311,643,954,353,147,80,374,464,2194,0.455,0.525,0.337,0.753,0.554,0.518
172,2023-24,UT Arlington,34,20,14,0.588,6825,880,1981,575,1120,305,861,549,747,404,871,1275,536,241,130,526,706,2614,0.444,0.513,0.354,0.735,0.56,0.521
173,2022-23,UT Arlington,32,11,21,0.344,6425,772,1863,565,1220,207,643,374,570,407,741,1148,432,204,96,443,619,2125,0.414,0.463,0.322,0.656,0.498,0.47
174,2021-22,UT Arlington,29,11,18,0.379,6000,711,1696,527,1109,184,587,342,488,335,732,1067,405,227,123,406,520,1948,0.419,0.475,0.313,0.701,0.505,0.473
175,2020-21,UT Arlington,26,13,13,0.5,5225,677,1659,442,1000,235,659,327,444,303,670,973,356,215,124,311,434,1916,0.408,0.442,0.357,0.736,0.512,0.479
176,2019-20,UT Arlington,32,14,18,0.438,6475,800,1926,550,1119,250,807,409,547,322,861,1183,478,186,90,358,569,2259,0.415,0.492,0.31,0.748,0.517,0.48
177,2023-24,USC Upstate,30,10,20,0.333,6075,780,1753,550,1062,230,691,340,530,262,688,950,375,217,96,346,589,2130,0.445,0.518,0.333,0.642,0.531,0.511
178,2022-23,USC Upstate,32,16,16,0.5,6425,808,1773,599,1152,209,621,373,570,268,746,1014,374,237,146,421,637,2198,0.456,0.52,0.337,0.654,0.538,0.515
179,2021-22,USC Upstate,32,15,17,0.469,6450,815,1823,558,1119,257,704,400,529,243,798,1041,438,203,106,407,612,2287,0.447,0.499,0.365,0.756,0.551,0.518
180,2020-21,USC Upstate,23,5,18,0.217,4600,538,1269,367,761,171,508,268,372,186,531,717,276,143,57,325,426,1515,0.424,0.482,0.337,0.72,0.524,0.491
181,2019-20,USC Upstate,33,13,20,0.394,6600,811,1911,587,1214,224,697,440,641,318,770,1088,415,195,80,410,627,2286,0.424,0.484,0.321,0.686,0.516,0.483
182,2023-24,UNLV,34,21,13,0.618,6900,906,1959,675,1274,231,685,458,633,350,814,1164,450,208,154,376,540,2501,0.462,0.53,0.337,0.724,0.553,0.521
183,2022-23,UNLV,32,19,13,0.594,6525,819,1895,557,1144,262,751,476,658,335,746,1081,411,291,122,394,547,2376,0.432,0.487,0.349,0.723,0.538,0.501
184,2021-22,UNLV,32,18,14,0.563,6400,782,1842,519,1059,263,783,409,554,308,848,1156,442,196,90,358,571,2236,0.425,0.49,0.336,0.738,0.531,0.496
185,2020-21,UNLV,27,12,15,0.444,5400,706,1587,481,948,225,639,238,336,277,696,973,356,172,76,338,488,1875,0.445,0.507,0.352,0.708,0.537,0.516
186,2019-20,UNLV,32,17,15,0.531,6575,812,1876,571,1121,241,755,442,639,396,859,1255,404,199,88,427,657,2307,0.433,0.509,0.319,0.692,0.529,0.497
187,2023-24,UNC Wilmington,31,21,10,0.677,6300,863,1871,605,1130,258,741,477,628,330,736,1066,379,202,75,266,527,2461,0.461,0.535,0.348,0.76,0.567,0.53
188,2022-23,UNC Wilmington,34,24,10,0.706,6875,813,1832,604,1208,209,624,508,697,324,806,1130,365,230,95,408,624,2343,0.444,0.5,0.335,0.729,0.542,0.501
189,2021-22,UNC Wilmington,36,27,9,0.75,7350,904,2130,647,1359,257,771,531,715,368,837,1205,383,274,145,361,647,2596,0.424,0.476,0.333,0.743,0.526,0.485
190,2020-21,UNC Wilmington,17,7,10,0.412,3425,442,1011,314,640,128,371,285,372,162,386,548,206,103,60,190,306,1297,0.437,0.491,0.345,0.766,0.546,0.5
191,2019-20,UNC Wilmington,32,10,22,0.313,6450,783,1816,575,1206,208,610,412,581,270,818,1088,385,200,96,417,559,2186,0.431,0.477,0.341,0.709,0.522,0.488
192,2023-24,UNC Greensboro,32,21,11,0.656,6450,865,1878,543,1066,322,812,370,507,319,814,1133,473,223,81,349,549,2422,0.461,0.509,0.397,0.73,0.572,0.546
193,2022-23,UNC Greensboro,32,20,12,0.625,6455,816,1831,562,1113,254,718,420,587,330,850,1180,465,228,83,376,535,2306,0.446,0.505,0.354,0.716,0.546,0.515
194,2021-22,UNC Greensboro,32,17,15,0.531,6475,750,1741,516,1057,234,684,349,484,348,771,1119,386,205,51,415,491,2083,0.431,0.488,0.342,0.721,0.528,0.498
195,2020-21,UNC Greensboro,30,21,9,0.7,6025,822,1954,594,1191,228,763,317,464,377,797,1174,370,224,115,329,542,2189,0.421,0.499,0.299,0.683,0.503,0.479
196,2019-20,UNC Greensboro,32,23,9,0.719,6475,879,2031,600,1174,279,857,335,531,415,767,1182,404,298,136,372,584,2372,0.433,0.511,0.326,0.631,0.519,0.501
197,2023-24,UNC Asheville,34,22,12,0.647,6875,906,1950,629,1191,277,759,593,799,319,863,1182,534,203,146,403,581,2682,0.465,0.528,0.365,0.742,0.576,0.536
198,2022-23,UNC Asheville,35,27,8,0.771,7100,897,1890,623,1183,274,707,536,772,295,924,1219,446,221,140,496,542,2604,0.475,0.527,0.388,0.694,0.577,0.547
199,2021-22,UNC Asheville,32,17,15,0.531,6550,831,1817,568,1093,263,724,485,668,298,787,1085,407,208,157,393,505,2410,0.457,0.52,0.363,0.726,0.565,0.53
200,2020-21,UNC Asheville,20,10,10,0.5,4075,548,1152,387,702,161,450,211,348,186,483,669,254,140,87,301,368,1468,0.476,0.551,0.358,0.606,0.557,0.546
201,2019-20,UNC Asheville,31,15,16,0.484,6225,837,1824,594,1122,243,702,409,620,264,673,937,336,255,73,354,604,2326,0.459,0.529,0.346,0.66,0.549,0.525
202,2023-24,UMBC,32,11,21,0.344,6425,955,2049,700,1335,255,714,352,504,304,875,1179,417,163,126,418,505,2517,0.466,0.524,0.357,0.698,0.55,0.528
203,2022-23,UMBC,32,18,14,0.563,6425,869,1931,612,1177,257,754,383,511,297,796,1093,456,180,81,323,467,2378,0.45,0.52,0.341,0.75,0.547,0.517
204,2021-22,UMBC,32,18,14,0.563,6425,813,1832,519,1054,294,778,439,560,236,812,1048,396,153,66,351,427,2359,0.444,0.492,0.378,0.784,0.562,0.524
205,2020-21,UMBC,20,14,6,0.7,4000,483,1099,344,691,139,408,286,402,175,555,730,219,102,35,258,336,1391,0.439,0.498,0.341,0.711,0.539,0.503
206,2019-20,UMBC,33,16,17,0.485,6625,816,1843,587,1120,229,723,394,611,297,839,1136,407,178,79,416,532,2255,0.443,0.524,0.317,0.645,0.529,0.505
207,2023-24,UMass Lowell,32,22,10,0.688,6450,913,1924,727,1358,186,566,549,746,367,938,1305,406,222,157,425,480,2561,0.475,0.535,0.329,0.736,0.562,0.523
208,2022-23,UMass Lowell,34,26,8,0.765,6825,965,1995,729,1376,236,619,487,662,406,908,1314,486,237,164,466,572,2653,0.484,0.53,0.381,0.736,0.574,0.543
209,2021-22,UMass Lowell,31,15,16,0.484,6250,831,1867,648,1269,183,598,346,493,324,789,1113,362,227,129,386,495,2191,0.445,0.511,0.306,0.702,0.521,0.494
210,2020-21,UMass Lowell,23,11,12,0.478,4600,560,1240,410,807,150,433,305,461,201,593,794,267,115,89,334,469,1575,0.452,0.508,0.346,0.662,0.54,0.512
211,2019-20,UMass Lowell,32,13,19,0.406,6475,838,1830,616,1175,222,655,490,688,301,786,1087,462,221,83,430,536,2388,0.458,0.524,0.339,0.712,0.554,0.519
212,2023-24,UCLA,33,16,17,0.485,6600,762,1820,579,1268,183,552,470,644,339,776,1115,368,192,109,358,609,2177,0.419,0.457,0.332,0.73,0.512,0.469
213,2022-23,UCLA,37,31,6,0.838,7400,1033,2245,806,1594,227,651,450,616,418,889,1307,538,310,142,371,573,2743,0.46,0.506,0.349,0.731,0.54,0.511
214,2021-22,UCLA,35,27,8,0.771,7125,967,2148,730,1477,237,671,468,632,394,887,1281,486,244,116,313,554,2639,0.45,0.494,0.353,0.741,0.539,0.505
215,2020-21,UCLA,32,22,10,0.688,6625,856,1855,638,1269,218,586,419,586,312,805,1117,437,158,89,336,514,2349,0.461,0.503,0.372,0.715,0.551,0.52
216,2019-20,UCLA,31,19,12,0.613,6250,751,1732,565,1156,186,576,465,648,370,766,1136,401,208,105,409,571,2153,0.434,0.489,0.323,0.718,0.528,0.487
217,2023-24,UCF,33,17,16,0.515,6625,817,1945,592,1247,225,698,507,723,408,835,1243,375,287,165,413,601,2366,0.42,0.475,0.322,0.701,0.517,0.478
218,2022-23,UCF,34,19,15,0.559,6975,848,1980,553,1145,295,835,441,572,393,797,1190,469,261,129,452,566,2432,0.428,0.483,0.353,0.771,0.54,0.503
219,2021-22,UCF,30,18,12,0.6,6025,740,1748,476,994,264,754,351,499,332,725,1057,435,210,110,391,471,2095,0.423,0.479,0.35,0.703,0.528,0.499
220,2020-21,UCF,23,11,12,0.478,4625,542,1262,362,755,180,507,282,387,216,549,765,285,157,79,340,389,1546,0.429,0.479,0.355,0.729,0.535,0.501
221,2019-20,UCF,30,16,14,0.533,6050,739,1713,526,1054,213,659,376,529,301,738,1039,404,195,87,414,498,2067,0.431,0.499,0.323,0.711,0.526,0.494
222,2023-24,UC Santa Barbara,31,16,15,0.516,6250,826,1684,639,1165,187,519,498,677,252,829,1081,417,152,99,405,511,2337,0.49,0.548,0.36,0.736,0.583,0.546
223,2022-23,UC Santa Barbara,35,27,8,0.771,7025,924,1875,730,1320,194,555,468,644,279,834,1113,495,222,87,397,562,2510,0.493,0.553,0.35,0.727,0.575,0.545
224,2021-22,UC Santa Barbara,28,17,11,0.607,5725,755,1527,603,1069,152,458,404,571,254,723,977,438,175,82,371,483,2066,0.494,0.564,0.332,0.708,0.574,0.544
225,2020-21,UC Santa Barbara,27,22,5,0.815,5450,739,1534,558,1012,181,522,392,522,251,700,951,438,199,75,294,429,2051,0.482,0.551,0.347,0.751,0.575,0.541
226,2019-20,UC Santa Barbara,31,21,10,0.677,6225,765,1672,565,1087,200,585,465,615,318,743,1061,430,147,78,366,521,2195,0.458,0.52,0.342,0.756,0.559,0.517
227,2023-24,UC San Diego,33,21,12,0.636,6675,884,1933,591,1115,293,818,469,624,317,830,1147,429,205,91,320,532,2530,0.457,0.53,0.358,0.752,0.567,0.533
228,2022-23,UC San Diego,30,10,20,0.333,6150,740,1720,512,1025,228,695,349,472,249,755,1004,359,174,67,362,482,2057,0.43,0.5,0.328,0.739,0.529,0.497
229,2021-22,UC San Diego,29,13,16,0.448,5825,697,1571,432,855,265,716,377,504,172,714,886,395,167,53,364,424,2036,0.444,0.505,0.37,0.748,0.562,0.528
230,2020-21,UC San Diego,17,7,10,0.412,3425,447,973,259,473,188,500,132,207,99,402,501,294,116,37,225,232,1214,0.459,0.548,0.376,0.638,0.567,0.556
231,2023-24,UC Riverside,34,16,18,0.471,6832,842,2122,555,1218,287,904,433,604,420,836,1256,446,191,48,326,586,2404,0.397,0.456,0.317,0.717,0.499,0.464
232,2022-23,UC Riverside,34,22,12,0.647,6900,906,2047,622,1263,284,784,367,526,390,861,1251,450,175,61,417,629,2463,0.443,0.492,0.362,0.698,0.536,0.512
233,2021-22,UC Riverside,28,16,12,0.571,5675,683,1544,482,916,201,628,298,414,221,774,995,373,147,37,345,449,1865,0.442,0.526,0.32,0.72,0.536,0.507
234,2020-21,UC Riverside,22,14,8,0.636,4450,572,1280,371,738,201,542,199,282,189,610,799,308,116,51,264,384,1544,0.447,0.503,0.371,0.706,0.546,0.525
235,2019-20,UC Riverside,32,17,15,0.531,6425,744,1707,490,985,254,722,317,460,280,865,1145,394,159,86,421,559,2059,0.436,0.497,0.352,0.689,0.535,0.51
236,2023-24,UC Irvine,34,24,10,0.706,6850,967,2035,770,1470,197,565,508,675,360,927,1287,529,219,113,393,624,2639,0.475,0.524,0.349,0.753,0.56,0.524
237,2022-23,UC Irvine,35,23,12,0.657,7025,969,2082,722,1426,247,656,432,600,341,955,1296,518,245,87,431,666,2617,0.465,0.506,0.377,0.72,0.553,0.525
238,2021-22,UC Irvine,25,15,10,0.6,5000,609,1377,483,989,126,388,312,408,250,658,908,273,150,89,338,450,1656,0.442,0.488,0.325,0.765,0.527,0.488
239,2020-21,UC Irvine,27,18,9,0.667,5450,729,1615,597,1225,132,390,360,474,303,766,1069,319,204,108,350,450,1950,0.451,0.487,0.338,0.759,0.53,0.492
240,2019-20,UC Irvine,32,21,11,0.656,6400,888,1878,690,1319,198,559,393,532,366,898,1264,475,206,119,443,588,2367,0.473,0.523,0.354,0.739,0.555,0.526
241,2023-24,UC Davis,33,20,13,0.606,6650,799,1808,569,1124,230,684,523,699,327,775,1102,411,257,116,444,633,2351,0.442,0.506,0.336,0.748,0.549,0.506
242,2022-23,UC Davis,32,18,14,0.563,6475,809,1820,595,1190,214,630,560,790,377,809,1186,389,227,90,471,600,2392,0.445,0.5,0.34,0.709,0.545,0.503
243,2021-22,UC Davis,24,13,11,0.542,4825,601,1366,455,928,146,438,280,397,213,610,823,272,144,69,300,443,1628,0.44,0.49,0.333,0.705,0.524,0.493
244,2020-21,UC Davis,18,10,8,0.556,3675,449,1020,347,705,102,315,295,376,160,411,571,195,135,50,261,359,1295,0.44,0.492,0.324,0.785,0.54,0.49
245,2019-20,UC Davis,32,14,18,0.438,6450,816,1769,557,1116,259,653,439,558,234,748,982,409,185,57,408,593,2330,0.461,0.499,0.397,0.787,0.573,0.534
246,2023-24,UAB,35,23,12,0.657,7100,937,2085,722,1427,215,658,622,834,451,878,1329,473,236,159,406,555,2711,0.449,0.506,0.327,0.746,0.546,0.501
247,2022-23,UAB,39,29,10,0.744,8025,1112,2462,836,1684,276,778,649,876,526,1069,1595,551,314,166,488,664,3149,0.452,0.496,0.355,0.741,0.547,0.508
248,2021-22,UAB,35,27,8,0.771,7075,1035,2212,759,1478,276,734,465,629,424,915,1339,453,334,146,402,579,2811,0.468,0.514,0.376,0.739,0.56,0.53
249,2020-21,UAB,29,22,7,0.759,5800,788,1746,641,1271,147,475,382,549,311,752,1063,308,231,121,304,441,2105,0.451,0.504,0.309,0.696,0.524,0.493
250,2019-20,UAB,32,19,13,0.594,6400,780,1719,611,1204,169,515,425,604,328,858,1186,337,191,93,471,527,2154,0.454,0.507,0.328,0.704,0.537,0.503
251,2023-24,Tulsa,31,16,15,0.516,6275,779,1775,540,1044,239,731,528,717,270,821,1091,392,243,105,403,543,2325,0.439,0.517,0.327,0.736,0.549,0.506
252,2022-23,Tulsa,30,5,25,0.167,6050,715,1733,485,998,230,735,299,463,271,687,958,348,164,45,397,464,1959,0.413,0.486,0.313,0.646,0.502,0.479
253,2021-22,Tulsa,31,11,20,0.355,6200,745,1717,533,1098,212,619,387,533,278,733,1011,365,212,69,397,496,2089,0.434,0.485,0.342,0.726,0.53,0.496
254,2020-21,Tulsa,23,11,12,0.478,4600,566,1262,407,758,159,504,282,416,204,577,781,327,146,46,307,379,1573,0.448,0.537,0.315,0.678,0.539,0.511
255,2019-20,Tulsa,31,21,10,0.677,6300,728,1653,546,1087,182,566,465,657,268,801,1069,391,234,70,417,469,2103,0.44,0.502,0.322,0.708,0.535,0.495
256,2023-24,Tulane,31,14,17,0.452,6300,856,1798,623,1145,233,653,595,813,217,813,1030,440,243,136,347,530,2540,0.476,0.544,0.357,0.732,0.581,0.541
257,2022-23,Tulane,31,20,11,0.645,6300,861,1873,620,1160,241,713,515,663,211,826,1037,485,262,130,351,511,2478,0.46,0.534,0.338,0.777,0.566,0.524
258,2021-22,Tulane,29,14,15,0.483,5875,734,1661,500,1020,234,641,419,554,195,722,917,392,230,95,305,466,2121,0.442,0.49,0.365,0.756,0.551,0.512
259,2020-21,Tulane,23,10,13,0.435,4600,486,1269,335,762,151,507,347,465,191,561,752,269,172,71,258,361,1470,0.383,0.44,0.298,0.746,0.493,0.442
260,2019-20,Tulane,30,12,18,0.4,6050,702,1709,472,1020,230,689,416,584,245,683,928,337,254,76,355,470,2050,0.411,0.463,0.334,0.712,0.516,0.478
261,2023-24,Troy,32,20,12,0.625,6500,859,1950,583,1163,276,787,552,753,427,803,1230,438,331,105,441,611,2546,0.441,0.501,0.351,0.733,0.552,0.511
262,2022-23,Troy,33,20,13,0.606,6650,858,1945,603,1147,255,798,443,632,362,789,1151,447,288,86,424,559,2414,0.441,0.526,0.32,0.701,0.538,0.507
263,2021-22,Troy,32,20,12,0.625,6450,770,1812,530,1079,240,733,434,597,357,831,1188,441,252,71,490,564,2214,0.425,0.491,0.327,0.727,0.528,0.491
264,2020-21,Troy,28,11,17,0.393,5625,636,1596,465,977,171,619,386,555,302,754,1056,320,175,87,417,480,1829,0.398,0.476,0.276,0.695,0.492,0.452
265,2019-20,Troy,31,9,22,0.29,6250,750,1878,489,1057,261,821,370,549,369,764,1133,430,178,83,441,584,2131,0.399,0.463,0.318,0.674,0.498,0.469
266,2023-24,Towson,34,20,14,0.588,6875,818,1934,602,1275,216,659,444,672,491,846,1337,381,210,142,413,565,2296,0.423,0.472,0.328,0.661,0.509,0.479
267,2022-23,Towson,33,21,12,0.636,6675,860,1922,617,1259,243,663,405,572,407,825,1232,461,205,113,404,538,2368,0.447,0.49,0.367,0.708,0.54,0.511
268,2021-22,Towson,34,25,9,0.735,6825,870,1943,605,1200,265,743,473,658,399,842,1241,458,247,92,404,590,2478,0.448,0.504,0.357,0.719,0.549,0.516
269,2020-21,Towson,18,4,14,0.222,3650,434,1055,344,744,90,311,256,352,225,441,666,170,90,50,224,318,1214,0.411,0.462,0.289,0.727,0.497,0.454
270,2019-20,Towson,32,19,13,0.594,6450,790,1824,580,1214,210,610,468,607,363,826,1189,364,180,101,380,583,2258,0.433,0.478,0.344,0.771,0.534,0.491
271,2023-24,Toledo,32,20,12,0.625,6450,920,1926,713,1376,207,550,513,680,318,763,1081,430,233,64,342,498,2560,0.478,0.518,0.376,0.754,0.569,0.531
272,2022-23,Toledo,35,27,8,0.771,7000,1057,2138,755,1374,302,764,573,744,353,839,1192,521,238,102,336,564,2989,0.494,0.549,0.395,0.77,0.6,0.565
273,2021-22,Toledo,34,26,8,0.765,6800,1017,2122,782,1458,235,664,448,594,362,995,1357,519,188,94,348,513,2717,0.479,0.536,0.354,0.754,0.565,0.535
274,2020-21,Toledo,30,21,9,0.7,6075,852,1869,538,1026,314,843,415,532,322,807,1129,480,184,74,332,458,2433,0.456,0.524,0.372,0.78,0.573,0.54
275,2019-20,Toledo,32,17,15,0.531,6425,802,1843,519,1069,283,774,499,669,321,890,1211,464,180,108,390,511,2386,0.435,0.486,0.366,0.746,0.552,0.512
276,2023-24,The Citadel,32,11,21,0.344,6425,819,1782,622,1182,197,600,425,602,300,794,1094,359,179,84,385,447,2260,0.46,0.526,0.328,0.706,0.546,0.515
277,2022-23,The Citadel,32,10,22,0.313,6400,771,1786,543,1084,228,702,388,514,234,781,1015,365,176,85,393,539,2158,0.432,0.501,0.325,0.755,0.531,0.496
278,2021-22,The Citadel,31,13,18,0.419,6325,838,1884,506,946,332,938,373,555,289,868,1157,500,146,111,377,475,2381,0.445,0.535,0.354,0.672,0.554,0.533
279,2020-21,The Citadel,25,13,12,0.52,5000,708,1566,452,846,256,720,347,495,237,707,944,389,136,108,302,405,2019,0.452,0.534,0.356,0.701,0.56,0.534
280,2019-20,The Citadel,30,6,24,0.2,6075,789,1820,509,967,280,853,386,559,247,775,1022,432,202,88,456,514,2244,0.434,0.526,0.328,0.691,0.538,0.51
281,2023-24,Texas–Rio Grande Valley,31,6,25,0.194,6250,754,1801,594,1254,160,547,513,728,290,747,1037,400,251,92,434,563,2181,0.419,0.474,0.293,0.705,0.508,0.463
282,2022-23,Texas–Rio Grande Valley,32,15,17,0.469,6450,868,1852,646,1197,222,655,560,802,345,866,1211,505,151,104,514,641,2518,0.469,0.54,0.339,0.698,0.564,0.529
283,2021-22,Texas–Rio Grande Valley,31,8,23,0.258,6200,759,1722,563,1078,196,644,498,717,271,799,1070,379,162,99,477,620,2212,0.441,0.522,0.304,0.695,0.536,0.498
284,2020-21,Texas–Rio Grande Valley,19,9,10,0.474,3800,476,1164,350,735,126,429,298,468,256,487,743,289,169,81,281,409,1376,0.409,0.476,0.294,0.637,0.496,0.463
285,2019-20,Texas–Rio Grande Valley,30,14,16,0.467,6075,779,1789,588,1232,191,557,440,614,314,678,992,451,251,111,376,595,2189,0.435,0.477,0.343,0.717,0.526,0.489
286,2023-24,Texas Tech,34,23,11,0.676,6825,877,1943,588,1139,289,804,518,664,338,850,1188,501,204,86,378,508,2561,0.451,0.516,0.359,0.78,0.567,0.526
287,2022-23,Texas Tech,32,16,16,0.5,6450,831,1810,601,1144,230,666,455,630,334,791,1125,413,234,93,441,494,2347,0.459,0.525,0.345,0.722,0.556,0.523
288,2021-22,Texas Tech,37,27,10,0.73,7475,969,2055,744,1355,225,700,504,722,391,957,1348,506,296,130,499,598,2667,0.472,0.549,0.321,0.698,0.556,0.526
289,2020-21,Texas Tech,29,18,11,0.621,5850,734,1672,549,1149,185,523,450,634,333,681,1014,377,207,116,313,502,2103,0.439,0.478,0.354,0.71,0.533,0.494
290,2019-20,Texas Tech,31,18,13,0.581,6300,779,1724,555,1093,224,631,448,594,279,754,1033,476,239,124,423,545,2230,0.452,0.508,0.355,0.754,0.556,0.517
291,2023-24,Texas State,35,17,18,0.486,7051,883,1988,724,1500,159,488,520,747,388,855,1243,413,258,118,470,617,2445,0.444,0.483,0.326,0.696,0.522,0.484
292,2022-23,Texas State,35,16,19,0.457,7000,848,1918,694,1417,154,501,459,630,359,784,1143,346,220,124,411,630,2309,0.442,0.49,0.307,0.729,0.521,0.482
293,2021-22,Texas State,29,21,8,0.724,5825,739,1598,556,1109,183,489,382,508,292,681,973,354,188,103,358,495,2043,0.462,0.501,0.374,0.752,0.555,0.52
294,2020-21,Texas State,25,18,7,0.72,5075,629,1361,490,995,139,366,263,372,231,591,822,339,172,73,332,422,1660,0.462,0.492,0.38,0.707,0.54,0.513
295,2019-20,Texas State,32,21,11,0.656,6475,840,1835,674,1325,166,510,493,652,319,783,1102,455,203,95,357,597,2339,0.458,0.509,0.325,0.756,0.545,0.503
296,2023-24,Texas Southern,33,16,17,0.485,6625,821,1980,579,1214,242,766,432,597,365,800,1165,384,228,124,415,610,2316,0.415,0.477,0.316,0.724,0.512,0.476
297,2022-23,Texas Southern,35,14,21,0.4,7149,894,2095,731,1507,163,588,471,709,405,908,1313,412,235,116,511,657,2422,0.427,0.485,0.277,0.664,0.498,0.466
298,2021-22,Texas Southern,32,19,13,0.594,6425,803,1854,623,1281,180,573,423,623,379,882,1261,343,178,165,478,566,2209,0.433,0.486,0.314,0.679,0.514,0.482
299,2020-21,Texas Southern,26,17,9,0.654,5225,695,1564,578,1140,117,424,414,592,313,751,1064,314,182,115,399,465,1921,0.444,0.507,0.276,0.699,0.521,0.482
300,2019-20,Texas Southern,32,16,16,0.5,6475,806,1927,638,1375,168,552,555,786,381,828,1209,360,205,94,504,610,2335,0.418,0.464,0.304,0.706,0.508,0.462
301,2023-24,Texas A&M–Corpus Christi,33,21,12,0.636,6675,889,2046,706,1430,183,616,519,738,438,890,1328,485,291,96,400,689,2480,0.435,0.494,0.297,0.703,0.517,0.479
302,2022-23,Texas A&M–Corpus Christi,35,24,11,0.686,7050,971,2152,703,1416,268,736,593,749,425,881,1306,536,296,60,448,665,2803,0.451,0.496,0.364,0.792,0.559,0.513
303,2021-22,Texas A&M–Corpus Christi,35,23,12,0.657,7025,943,2130,719,1464,224,666,572,776,447,894,1341,528,298,62,492,711,2682,0.443,0.491,0.336,0.737,0.537,0.495
304,2020-21,Texas A&M–Corpus Christi,24,5,19,0.208,4800,542,1296,389,833,153,463,317,462,206,609,815,308,165,74,401,425,1554,0.418,0.467,0.33,0.686,0.513,0.477
305,2019-20,Texas A&M–Corpus Christi,32,14,18,0.438,6400,740,1668,495,1015,245,653,387,547,304,788,1092,405,187,98,561,614,2112,0.444,0.488,0.375,0.707,0.548,0.517
306,2023-24,Texas A&M–Commerce,33,13,20,0.394,6825,829,1996,541,1074,288,922,415,592,316,759,1075,457,262,164,385,582,2361,0.415,0.504,0.312,0.701,0.518,0.487
307,2022-23,Texas A&M–Commerce,33,13,20,0.394,6725,859,1890,581,1022,278,868,366,522,303,760,1063,474,191,101,423,618,2362,0.454,0.568,0.32,0.701,0.552,0.528
308,2023-24,Texas A&M,36,21,15,0.583,7250,926,2304,671,1435,255,869,629,890,627,914,1541,412,250,108,346,611,2736,0.402,0.468,0.293,0.707,0.502,0.457
309,2022-23,Texas A&M,35,25,10,0.714,7000,835,1932,618,1266,217,666,662,872,435,853,1288,439,235,82,430,637,2549,0.432,0.488,0.326,0.759,0.543,0.488
310,2021-22,Texas A&M,40,27,13,0.675,8100,1034,2334,774,1535,260,799,580,825,483,936,1419,541,398,136,524,701,2908,0.443,0.504,0.325,0.703,0.533,0.499
311,2020-21,Texas A&M,18,8,10,0.444,3600,401,966,284,575,117,391,238,328,198,404,602,218,124,34,266,304,1157,0.415,0.494,0.299,0.726,0.516,0.476
312,2019-20,Texas A&M,30,16,14,0.533,6025,634,1570,445,927,189,643,437,645,322,697,1019,333,193,86,422,463,1894,0.404,0.48,0.294,0.678,0.505,0.464
313,2023-24,Texas,34,21,13,0.618,6825,932,1988,687,1297,245,691,454,600,339,840,1179,512,244,149,393,587,2563,0.469,0.53,0.355,0.757,0.564,0.53
314,2022-23,Texas,38,29,9,0.763,7675,1083,2289,809,1499,274,790,523,699,366,930,1296,614,299,136,439,663,2963,0.473,0.54,0.347,0.748,0.565,0.533
315,2021-22,Texas,34,22,12,0.647,6850,832,1886,607,1205,225,681,450,603,353,778,1131,450,261,115,393,608,2339,0.441,0.504,0.33,0.746,0.538,0.501
316,2020-21,Texas,27,19,8,0.704,5475,702,1547,470,895,232,652,372,524,291,745,1036,357,176,110,393,531,2008,0.454,0.525,0.356,0.71,0.559,0.529
317,2019-20,Texas,31,19,12,0.613,6200,740,1730,492,988,248,742,261,381,278,708,986,359,171,134,420,568,1989,0.428,0.498,0.334,0.685,0.52,0.499
318,2023-24,Tennessee Tech,31,10,21,0.323,6250,758,1692,556,1084,202,608,371,522,191,766,957,379,156,90,369,421,2089,0.448,0.513,0.332,0.711,0.538,0.508
319,2022-23,Tennessee Tech,33,16,17,0.485,6773,860,1967,558,1138,302,829,410,570,310,849,1159,476,207,80,416,527,2432,0.437,0.49,0.364,0.719,0.543,0.514
320,2021-22,Tennessee Tech,32,11,21,0.344,6450,897,1998,673,1343,224,655,310,469,371,816,1187,512,232,119,424,464,2328,0.449,0.501,0.342,0.661,0.524,0.505
321,2020-21,Tennessee Tech,27,5,22,0.185,5425,656,1517,448,869,208,648,277,410,245,663,908,382,176,62,430,430,1797,0.432,0.516,0.321,0.676,0.525,0.501
322,2019-20,Tennessee Tech,31,9,22,0.29,6250,754,1826,497,1050,257,776,268,397,327,745,1072,431,213,93,463,460,2033,0.413,0.473,0.331,0.675,0.505,0.483
323,2023-24,Tennessee State,33,18,15,0.545,6625,832,1881,615,1214,217,667,519,687,327,817,1144,396,220,116,436,644,2400,0.442,0.507,0.325,0.755,0.544,0.5
324,2022-23,Tennessee State,32,18,14,0.563,6403,868,1935,587,1131,281,804,482,694,336,828,1164,427,187,105,403,654,2499,0.449,0.519,0.35,0.695,0.552,0.521
325,2021-22,Tennessee State,32,14,18,0.438,6425,825,1852,614,1249,211,603,421,589,332,788,1120,393,216,107,444,610,2282,0.445,0.492,0.35,0.715,0.535,0.502
326,2020-21,Tennessee State,23,4,19,0.174,4650,568,1342,430,862,138,480,299,438,215,560,775,268,170,73,353,478,1573,0.423,0.499,0.288,0.683,0.507,0.475
327,2019-20,Tennessee State,33,18,15,0.545,6650,862,1836,622,1150,240,686,386,585,343,902,1245,447,175,136,573,670,2355,0.469,0.541,0.35,0.66,0.557,0.535
328,2023-24,Tennessee,36,27,9,0.75,7200,979,2223,664,1308,315,915,563,750,419,974,1393,600,280,166,367,629,2836,0.44,0.508,0.344,0.751,0.55,0.511
329,2022-23,Tennessee,36,25,11,0.694,7225,908,2097,632,1257,276,840,455,643,464,918,1382,601,297,130,431,596,2547,0.433,0.503,0.329,0.708,0.53,0.499
330,2021-22,Tennessee,35,27,8,0.771,7050,915,2107,610,1259,305,848,436,610,409,881,1290,576,326,150,429,592,2571,0.434,0.485,0.36,0.715,0.536,0.507
331,2020-21,Tennessee,27,18,9,0.667,5400,682,1554,504,1016,178,538,399,535,294,674,968,401,196,130,337,444,1941,0.439,0.496,0.331,0.746,0.537,0.496
332,2019-20,Tennessee,31,17,14,0.548,6200,715,1656,528,1058,187,598,462,617,311,758,1069,448,186,174,423,563,2079,0.432,0.499,0.313,0.749,0.533,0.488
333,2023-24,Temple,36,16,20,0.444,7350,876,2214,580,1283,296,931,503,709,406,898,1304,402,265,105,357,610,2551,0.396,0.452,0.318,0.709,0.5,0.463
334,2022-23,Temple,32,16,16,0.5,6525,754,1774,499,1001,255,773,464,613,311,815,1126,441,159,128,434,538,2227,0.425,0.499,0.33,0.757,0.539,0.497
335,2021-22,Temple,29,17,12,0.586,5850,649,1644,454,1016,195,628,443,652,356,768,1124,342,196,135,364,533,1936,0.395,0.447,0.311,0.679,0.495,0.454
336,2020-21,Temple,16,5,11,0.313,3200,348,868,233,532,115,336,242,338,148,432,580,214,67,39,213,281,1053,0.401,0.438,0.342,0.716,0.512,0.467
337,2019-20,Temple,31,14,17,0.452,6275,744,1843,536,1198,208,645,421,613,303,863,1166,429,239,94,400,549,2117,0.404,0.447,0.322,0.687,0.496,0.46
338,2023-24,TCU,34,21,13,0.618,6900,964,2089,740,1457,224,632,535,732,433,830,1263,575,305,128,438,593,2687,0.461,0.508,0.354,0.731,0.551,0.515
339,2022-23,TCU,35,22,13,0.629,7025,965,2128,768,1492,197,636,507,725,402,852,1254,565,281,166,416,578,2634,0.453,0.515,0.31,0.699,0.533,0.5
340,2021-22,TCU,34,21,13,0.618,6850,862,1963,674,1341,188,622,416,617,442,884,1326,464,219,141,492,527,2328,0.439,0.503,0.302,0.674,0.516,0.487
341,2020-21,TCU,26,12,14,0.462,5225,625,1428,450,910,175,518,311,463,255,645,900,338,157,90,369,407,1738,0.438,0.495,0.338,0.672,0.527,0.499
342,2019-20,TCU,32,16,16,0.5,6475,758,1798,484,1019,274,779,303,476,359,759,1118,468,220,156,455,525,2093,0.422,0.475,0.352,0.637,0.517,0.498
343,2023-24,Tarleton State,35,25,10,0.714,7025,951,2091,748,1468,203,623,488,645,379,813,1192,482,308,124,395,605,2593,0.455,0.51,0.326,0.757,0.541,0.503
344,2022-23,Tarleton State,34,17,17,0.5,6850,847,1868,684,1391,163,477,589,837,325,752,1077,437,330,96,424,694,2446,0.453,0.492,0.342,0.704,0.54,0.497
345,2021-22,Tarleton State,31,14,17,0.452,6225,705,1683,549,1172,156,511,436,578,292,654,946,349,237,68,378,562,2002,0.419,0.468,0.305,0.754,0.511,0.465
346,2020-21,Tarleton State,20,10,10,0.5,4000,530,1129,420,838,110,291,297,412,170,469,639,294,209,53,231,391,1467,0.469,0.501,0.378,0.721,0.554,0.518
347,2023-24,Syracuse,32,20,12,0.625,6400,883,1915,664,1264,219,651,457,634,277,787,1064,442,290,129,364,493,2442,0.461,0.525,0.336,0.721,0.551,0.518
348,2022-23,Syracuse,32,17,15,0.531,6450,871,1883,673,1336,198,547,432,577,324,789,1113,459,241,161,373,427,2372,0.463,0.504,0.362,0.749,0.55,0.515
349,2021-22,Syracuse,33,16,17,0.485,6725,915,2029,615,1234,300,795,423,574,350,848,1198,482,231,124,354,470,2553,0.451,0.498,0.377,0.737,0.555,0.525
350,2020-21,Syracuse,28,18,10,0.643,5625,743,1681,506,1003,237,678,372,476,285,705,990,419,227,141,317,409,2095,0.442,0.504,0.35,0.782,0.549,0.512
351,2019-20,Syracuse,32,18,14,0.563,6450,813,1865,554,1080,259,785,493,666,336,809,1145,447,237,143,363,522,2378,0.436,0.513,0.33,0.74,0.545,0.505
352,2023-24,Stony Brook,35,20,15,0.571,7150,921,2101,644,1326,277,775,454,614,336,944,1280,424,211,113,359,532,2573,0.438,0.486,0.357,0.739,0.538,0.504
353,2022-23,Stony Brook,33,11,22,0.333,6625,726,1756,470,962,256,794,375,504,252,867,1119,389,144,83,413,499,2083,0.413,0.489,0.322,0.744,0.522,0.486
354,2021-22,Stony Brook,31,18,13,0.581,6225,815,1860,561,1111,254,749,377,501,299,779,1078,346,208,90,328,443,2261,0.438,0.505,0.339,0.752,0.539,0.506
355,2020-21,Stony Brook,23,9,14,0.391,4650,543,1318,403,845,140,473,296,434,262,613,875,278,129,114,318,387,1522,0.412,0.477,0.296,0.682,0.499,0.465
356,2019-20,Stony Brook,33,20,13,0.606,6650,777,1909,503,1087,274,822,455,628,350,915,1265,368,221,152,480,544,2283,0.407,0.463,0.333,0.725,0.517,0.479
357,2023-24,Stonehill,31,4,27,0.129,6225,714,1788,461,954,253,834,286,415,257,763,1020,366,198,77,421,477,1967,0.399,0.483,0.303,0.689,0.495,0.47
358,2022-23,Stonehill,31,14,17,0.452,6275,720,1633,481,956,239,677,397,524,194,769,963,380,219,88,417,468,2076,0.441,0.503,0.353,0.758,0.552,0.514
359,2023-24,Stetson,35,22,13,0.629,7025,950,2053,637,1196,313,857,474,619,339,877,1216,465,187,108,369,516,2687,0.463,0.533,0.365,0.766,0.572,0.539
360,2022-23,Stetson,31,17,14,0.548,6351,857,1860,546,1049,311,811,356,461,320,765,1085,429,159,99,329,484,2381,0.461,0.52,0.383,0.772,0.573,0.544
361,2021-22,Stetson,30,11,19,0.367,6100,765,1779,510,1050,255,729,305,442,316,752,1068,430,211,88,389,445,2090,0.43,0.486,0.35,0.69,0.525,0.502
362,2020-21,Stetson,27,12,15,0.444,5450,687,1587,441,920,246,667,305,438,282,675,957,370,188,74,357,443,1925,0.433,0.479,0.369,0.696,0.536,0.51
363,2019-20,Stetson,33,16,17,0.485,6625,747,1678,567,1133,180,545,429,644,313,803,1116,323,209,79,452,517,2103,0.445,0.5,0.33,0.666,0.53,0.499
364,2023-24,Stephen F. Austin,33,18,15,0.545,6725,849,1890,646,1283,203,607,562,796,393,791,1184,422,295,93,530,697,2463,0.449,0.504,0.334,0.706,0.543,0.503
365,2022-23,Stephen F. Austin,32,19,13,0.594,6525,867,1834,664,1302,203,532,490,684,342,760,1102,482,284,83,493,685,2427,0.473,0.51,0.382,0.716,0.562,0.528
366,2021-22,Stephen F. Austin,32,22,10,0.688,6425,877,1849,688,1277,189,572,442,652,370,757,1127,481,290,130,526,630,2385,0.474,0.539,0.33,0.678,0.552,0.525
367,2020-21,Stephen F. Austin,21,16,5,0.762,4250,622,1195,522,898,100,297,342,503,243,506,749,331,199,73,348,419,1686,0.521,0.581,0.337,0.68,0.588,0.562
368,2019-20,Stephen F. Austin,31,28,3,0.903,6225,887,1806,708,1312,179,494,546,790,406,754,1160,464,324,101,550,649,2499,0.491,0.54,0.362,0.691,0.573,0.541
369,2023-24,Stanford,32,14,18,0.438,6500,882,1886,596,1112,286,774,393,540,248,849,1097,515,176,99,410,490,2443,0.468,0.536,0.37,0.728,0.57,0.543
370,2022-23,Stanford,33,14,19,0.424,6601,838,1853,571,1117,267,736,378,545,342,795,1137,490,188,106,413,557,2321,0.452,0.511,0.363,0.694,0.55,0.524
371,2021-22,Stanford,32,16,16,0.5,6425,770,1780,537,1092,233,688,351,533,368,813,1181,419,178,83,479,556,2124,0.433,0.492,0.339,0.659,0.522,0.498
372,2020-21,Stanford,27,14,13,0.519,5500,678,1461,533,1010,145,451,382,533,209,696,905,332,191,92,403,448,1883,0.464,0.528,0.322,0.717,0.549,0.514
373,2019-20,Stanford,32,20,12,0.625,6450,810,1726,583,1118,227,608,376,535,220,821,1041,414,218,119,459,521,2223,0.469,0.521,0.373,0.703,0.561,0.535
374,2023-24,St. Thomas,33,20,13,0.606,6625,859,1824,560,995,299,829,385,528,255,772,1027,451,204,71,303,520,2402,0.471,0.563,0.361,0.729,0.579,0.553
375,2022-23,St. Thomas,33,19,14,0.576,6600,847,1895,550,1051,297,844,456,581,272,780,1052,426,196,77,327,574,2447,0.447,0.523,0.352,0.785,0.564,0.525
376,2021-22,St. Thomas,30,10,20,0.333,6000,800,1815,466,880,334,935,307,405,186,701,887,377,155,38,243,511,2241,0.441,0.53,0.357,0.758,0.558,0.533
377,2023-24,St. Mary's (CA),34,26,8,0.765,6850,936,2007,678,1274,258,733,386,571,448,897,1345,550,223,130,347,556,2516,0.466,0.532,0.352,0.676,0.552,0.531
378,2022-23,St. Mary's (CA),35,27,8,0.771,7075,888,1952,625,1232,263,720,434,625,371,865,1236,436,239,122,373,579,2473,0.455,0.507,0.365,0.694,0.55,0.522
379,2021-22,St. Mary's (CA),34,26,8,0.765,6800,888,1915,642,1219,246,696,348,459,293,853,1146,458,235,86,382,529,2370,0.464,0.527,0.353,0.758,0.556,0.528
380,2020-21,St. Mary's (CA),24,14,10,0.583,4800,562,1331,414,828,148,503,270,368,203,622,825,257,145,74,270,400,1542,0.422,0.5,0.294,0.734,0.512,0.478
381,2019-20,St. Mary's (CA),34,26,8,0.765,7000,922,1925,646,1228,276,697,439,582,260,829,1089,404,224,68,336,562,2559,0.479,0.526,0.396,0.754,0.581,0.551
382,2023-24,St. John's (NY),33,20,13,0.606,6600,970,2139,733,1443,237,696,425,584,476,803,1279,518,232,180,360,593,2602,0.453,0.508,0.341,0.728,0.538,0.509
383,2022-23,St. John's (NY),33,18,15,0.545,6700,970,2159,777,1576,193,583,419,599,433,891,1324,500,272,123,462,535,2552,0.449,0.493,0.331,0.699,0.522,0.494
384,2021-22,St. John's (NY),32,17,15,0.531,6450,969,2137,737,1445,232,692,377,557,383,828,1211,600,283,175,381,572,2547,0.453,0.51,0.335,0.677,0.53,0.508
385,2020-21,St. John's (NY),27,16,11,0.593,5475,779,1744,579,1164,200,580,374,499,302,669,971,440,246,105,340,493,2132,0.447,0.497,0.345,0.749,0.538,0.504
386,2019-20,St. John's (NY),32,17,15,0.531,6400,865,2114,653,1453,212,661,445,633,397,831,1228,470,320,127,359,602,2387,0.409,0.449,0.321,0.703,0.494,0.459
387,2022-23,St. Francis Brooklyn,30,14,16,0.467,6025,688,1701,484,1124,204,577,366,524,342,674,1016,369,223,144,414,460,1946,0.404,0.431,0.354,0.698,0.499,0.464
388,2021-22,St. Francis Brooklyn,30,10,20,0.333,6050,746,1823,536,1155,210,668,315,443,338,720,1058,357,200,78,371,497,2017,0.409,0.464,0.314,0.711,0.496,0.467
389,2020-21,St. Francis Brooklyn,19,9,10,0.474,3825,542,1215,424,859,118,356,274,373,216,472,688,271,153,66,229,383,1476,0.446,0.494,0.331,0.735,0.53,0.495
390,2019-20,St. Francis Brooklyn,31,13,18,0.419,6225,798,1903,601,1239,197,664,373,511,328,796,1124,372,199,140,397,586,2168,0.419,0.485,0.297,0.73,0.505,0.471
391,2023-24,St. Bonaventure,33,20,13,0.606,6675,853,1872,602,1185,251,687,467,603,320,767,1087,412,218,128,358,553,2424,0.456,0.508,0.365,0.774,0.562,0.523
392,2022-23,St. Bonaventure,32,14,18,0.438,6450,769,1794,543,1144,226,650,372,529,301,747,1048,380,224,108,405,596,2136,0.429,0.475,0.348,0.703,0.522,0.492
393,2021-22,St. Bonaventure,33,23,10,0.697,6625,868,1917,668,1313,200,604,373,497,296,813,1109,451,209,157,341,439,2309,0.453,0.509,0.331,0.751,0.536,0.505
394,2020-21,St. Bonaventure,21,16,5,0.762,4200,542,1224,408,834,134,390,253,343,238,537,775,306,123,83,225,322,1471,0.443,0.489,0.344,0.738,0.53,0.498
395,2019-20,St. Bonaventure,31,19,12,0.613,6250,787,1805,577,1194,210,611,359,488,331,801,1132,427,171,104,364,532,2143,0.436,0.483,0.344,0.736,0.526,0.494
396,2023-24,Southern Utah,31,10,21,0.323,6225,820,1861,625,1212,195,649,491,674,322,727,1049,375,202,92,373,548,2326,0.441,0.516,0.3,0.728,0.533,0.493
397,2022-23,Southern Utah,37,24,13,0.649,7549,1064,2286,751,1399,313,887,623,859,395,1032,1427,485,268,125,492,680,3064,0.465,0.537,0.353,0.725,0.569,0.534
398,2021-22,Southern Utah,35,23,12,0.657,7100,962,2088,670,1237,292,851,504,706,353,963,1316,422,212,87,443,596,2720,0.461,0.542,0.343,0.714,0.561,0.531
399,2020-21,Southern Utah,24,20,4,0.833,4825,699,1475,488,857,211,618,412,551,263,683,946,338,168,63,290,405,2021,0.474,0.569,0.341,0.748,0.582,0.545
400,2019-20,Southern Utah,32,17,15,0.531,6500,834,1843,639,1254,195,589,466,651,292,891,1183,383,216,132,432,620,2329,0.453,0.51,0.331,0.716,0.541,0.505
401,2023-24,Southern Mississippi,32,16,16,0.5,6400,775,1826,574,1212,201,614,485,693,343,834,1177,376,229,154,411,550,2236,0.424,0.474,0.327,0.7,0.519,0.479
402,2022-23,Southern Mississippi,33,25,8,0.758,6600,881,1937,651,1223,230,714,444,622,366,837,1203,488,276,87,403,545,2436,0.455,0.532,0.322,0.714,0.546,0.514
403,2021-22,Southern Mississippi,33,7,26,0.212,6650,801,1866,624,1301,177,565,347,504,271,836,1107,406,165,91,439,529,2126,0.429,0.48,0.313,0.688,0.505,0.477
404,2020-21,Southern Mississippi,25,8,17,0.32,5025,603,1396,469,975,134,421,265,392,208,670,878,303,148,52,352,398,1605,0.432,0.481,0.318,0.676,0.507,0.48
405,2019-20,Southern Mississippi,31,9,22,0.29,6250,783,1766,620,1237,163,529,318,442,293,812,1105,444,180,78,464,490,2047,0.443,0.501,0.308,0.719,0.518,0.49
406,2023-24,Southern Indiana,32,8,24,0.25,6425,737,1811,522,1147,215,664,506,679,319,820,1139,362,204,94,423,672,2195,0.407,0.455,0.324,0.745,0.514,0.466
407,2022-23,Southern Indiana,33,16,17,0.485,6675,868,1999,548,1145,320,854,444,662,404,868,1272,420,237,77,440,604,2500,0.434,0.479,0.375,0.671,0.54,0.514
408,2023-24,Southern Illinois,32,19,13,0.594,6500,791,1746,527,985,264,761,479,629,270,785,1055,456,175,98,356,579,2325,0.453,0.535,0.347,0.762,0.569,0.529
409,2022-23,Southern Illinois,33,23,10,0.697,6626,769,1716,510,921,259,795,371,513,228,812,1040,459,238,70,414,539,2168,0.448,0.554,0.326,0.723,0.553,0.524
410,2021-22,Southern Illinois,31,16,15,0.516,6200,713,1600,474,925,239,675,320,464,218,725,943,372,170,65,354,473,1985,0.446,0.512,0.354,0.69,0.545,0.52
411,2020-21,Southern Illinois,26,12,14,0.462,5250,614,1362,404,802,210,560,266,400,139,633,772,352,160,48,311,370,1704,0.451,0.504,0.375,0.665,0.549,0.528
412,2019-20,Southern Illinois,32,16,16,0.5,6425,693,1623,467,955,226,668,390,536,208,747,955,369,208,65,397,469,2002,0.427,0.489,0.338,0.728,0.533,0.497
413,2023-24,Southern California,33,15,18,0.455,6700,872,1932,620,1223,252,709,450,649,331,792,1123,515,247,172,418,560,2446,0.451,0.507,0.355,0.693,0.546,0.517
414,2022-23,Southern California,33,22,11,0.667,6625,855,1878,641,1258,214,620,465,624,310,854,1164,445,227,167,410,568,2391,0.455,0.51,0.345,0.745,0.55,0.512
415,2021-22,Southern California,34,26,8,0.765,6850,910,2002,680,1358,230,644,411,619,399,964,1363,485,170,151,415,531,2461,0.455,0.501,0.357,0.664,0.536,0.512
416,2020-21,Southern California,33,25,8,0.758,6700,904,1916,690,1322,214,594,451,695,384,898,1282,458,157,168,408,498,2473,0.472,0.522,0.36,0.649,0.551,0.528
417,2019-20,Southern California,31,22,9,0.71,6275,781,1780,581,1209,200,571,417,630,333,861,1194,430,207,152,448,519,2179,0.439,0.481,0.35,0.662,0.524,0.495
418,2023-24,Southern,32,18,14,0.563,6450,807,1829,586,1145,221,684,440,653,312,708,1020,440,291,105,456,631,2275,0.441,0.512,0.323,0.674,0.532,0.502
419,2022-23,Southern,32,15,17,0.469,6450,804,1872,560,1135,244,737,448,627,281,756,1037,451,278,75,468,639,2300,0.429,0.493,0.331,0.715,0.53,0.495
420,2021-22,Southern,31,17,14,0.548,6225,791,1796,578,1192,213,604,434,624,296,680,976,415,325,80,449,634,2229,0.44,0.485,0.353,0.696,0.533,0.5
421,2020-21,Southern,19,8,11,0.421,3875,465,1077,361,755,104,322,293,436,184,506,690,267,155,49,309,391,1327,0.432,0.478,0.323,0.672,0.517,0.48
422,2019-20,Southern,32,17,15,0.531,6450,816,1854,645,1306,171,548,431,635,350,764,1114,425,222,79,445,698,2234,0.44,0.494,0.312,0.679,0.518,0.486
423,2023-24,Southeastern Louisiana,32,15,17,0.469,6451,764,1769,529,1092,235,677,446,613,343,777,1120,463,222,73,442,523,2209,0.432,0.484,0.347,0.728,0.536,0.498
424,2022-23,Southeastern Louisiana,32,18,14,0.563,6525,889,1942,641,1270,248,672,457,616,329,778,1107,453,233,58,390,557,2483,0.458,0.505,0.369,0.742,0.556,0.522
425,2021-22,Southeastern Louisiana,34,19,15,0.559,6825,911,1982,609,1137,302,845,555,732,314,804,1118,519,270,132,486,544,2679,0.46,0.536,0.357,0.758,0.575,0.536
426,2020-21,Southeastern Louisiana,26,8,18,0.308,5275,591,1498,414,891,177,607,416,614,314,573,887,261,180,64,414,509,1775,0.395,0.465,0.292,0.678,0.496,0.454
427,2019-20,Southeastern Louisiana,31,8,23,0.258,6275,779,1873,581,1204,198,669,401,594,337,663,1000,385,248,59,514,654,2157,0.416,0.483,0.296,0.675,0.5,0.469
428,2023-24,Southeast Missouri State,31,9,22,0.29,6225,764,1848,572,1217,192,631,358,512,279,705,984,383,178,78,371,606,2078,0.413,0.47,0.304,0.699,0.497,0.465
429,2022-23,Southeast Missouri State,36,19,17,0.528,7325,958,2191,672,1316,286,875,587,828,347,915,1262,497,251,115,471,767,2789,0.437,0.511,0.327,0.709,0.54,0.503
430,2021-22,Southeast Missouri State,32,14,18,0.438,6425,818,1871,537,1055,281,816,501,684,290,776,1066,446,207,85,420,649,2418,0.437,0.509,0.344,0.732,0.551,0.512
431,2020-21,Southeast Missouri State,27,11,16,0.407,5550,630,1468,425,886,205,582,399,595,258,691,949,374,185,64,415,513,1864,0.429,0.48,0.352,0.671,0.532,0.499
432,2019-20,Southeast Missouri State,31,7,24,0.226,6225,720,1727,529,1131,191,596,423,612,286,741,1027,353,161,64,414,577,2054,0.417,0.468,0.32,0.691,0.509,0.472
433,2023-24,South Florida,33,25,8,0.758,6600,837,1900,542,1096,295,804,530,719,328,861,1189,491,229,112,356,568,2499,0.441,0.495,0.367,0.737,0.557,0.518
434,2022-23,South Florida,32,14,18,0.438,6425,844,1894,608,1191,236,703,379,582,381,816,1197,429,207,98,437,568,2303,0.446,0.51,0.336,0.651,0.531,0.508
435,2021-22,South Florida,31,8,23,0.258,6200,670,1790,532,1243,138,547,303,455,350,764,1114,339,193,116,389,529,1781,0.374,0.428,0.252,0.666,0.444,0.413
436,2020-21,South Florida,22,9,13,0.409,4425,516,1277,378,855,138,422,279,438,275,556,831,251,116,62,308,378,1449,0.404,0.442,0.327,0.637,0.488,0.458
437,2019-20,South Florida,31,14,17,0.452,6250,672,1654,476,1019,196,635,403,620,352,699,1051,315,234,63,454,544,1943,0.406,0.467,0.309,0.65,0.499,0.466
438,2023-24,South Dakota State,35,22,13,0.629,7050,977,2029,677,1206,300,823,421,593,289,951,1240,450,213,112,395,501,2675,0.482,0.561,0.365,0.71,0.579,0.555
439,2022-23,South Dakota State,32,19,13,0.594,6450,812,1805,566,1105,246,700,400,505,223,817,1040,341,166,92,371,456,2270,0.45,0.512,0.351,0.792,0.555,0.518
440,2021-22,South Dakota State,35,30,5,0.857,7025,1078,2069,752,1336,326,733,523,690,258,983,1241,528,213,89,385,536,3005,0.521,0.563,0.445,0.758,0.627,0.6
441,2020-21,South Dakota State,23,16,7,0.696,4600,655,1315,470,857,185,458,355,496,178,644,822,327,127,71,283,370,1850,0.498,0.548,0.404,0.716,0.597,0.568
442,2019-20,South Dakota State,32,22,10,0.688,6475,914,1861,679,1184,235,677,430,608,302,922,1224,456,160,106,415,533,2493,0.491,0.573,0.347,0.707,0.58,0.554
443,2023-24,South Dakota,32,12,20,0.375,6500,875,1916,624,1247,251,669,433,583,334,864,1198,391,115,56,411,511,2434,0.457,0.5,0.375,0.743,0.555,0.522
444,2022-23,South Dakota,31,12,19,0.387,6200,755,1750,480,1044,275,706,364,476,267,774,1041,385,138,48,360,540,2149,0.431,0.46,0.39,0.765,0.544,0.51
445,2021-22,South Dakota,31,19,12,0.613,6250,829,1779,608,1188,221,591,450,600,272,793,1065,370,137,71,309,547,2329,0.466,0.512,0.374,0.75,0.564,0.528
446,2020-21,South Dakota,25,14,11,0.56,5000,674,1438,488,960,186,478,365,468,180,690,870,349,114,61,268,467,1899,0.469,0.508,0.389,0.78,0.572,0.533
447,2019-20,South Dakota,32,20,12,0.625,6400,889,1805,656,1209,233,596,536,710,200,845,1045,444,146,86,339,561,2547,0.493,0.543,0.391,0.755,0.594,0.557
448,2023-24,South Carolina State,32,14,18,0.438,6450,784,1914,584,1294,200,620,477,692,477,726,1203,435,267,111,487,666,2245,0.41,0.451,0.323,0.689,0.501,0.462
449,2022-23,South Carolina State,31,5,26,0.161,6250,838,1980,625,1309,213,671,385,575,429,668,1097,435,224,100,486,637,2274,0.423,0.477,0.317,0.67,0.505,0.477
450,2021-22,South Carolina State,31,15,16,0.484,6275,797,2030,600,1373,197,657,436,633,472,824,1296,379,206,111,458,614,2227,0.393,0.437,0.3,0.689,0.478,0.441
451,2020-21,South Carolina State,18,1,17,0.056,3600,401,1033,278,645,123,388,177,285,175,388,563,178,106,50,312,334,1102,0.388,0.431,0.317,0.621,0.472,0.448
452,2019-20,South Carolina State,29,11,18,0.379,5925,705,1618,559,1135,146,483,481,643,301,724,1025,328,132,53,418,541,2037,0.436,0.493,0.302,0.748,0.53,0.481
453,2023-24,South Carolina,34,26,8,0.765,6850,865,1970,591,1161,274,809,446,627,387,823,1210,524,162,108,344,550,2450,0.439,0.509,0.339,0.711,0.54,0.509
454,2022-23,South Carolina,32,11,21,0.344,6500,744,1846,500,1091,244,755,327,495,378,713,1091,355,157,84,421,512,2059,0.403,0.458,0.323,0.661,0.495,0.469
455,2021-22,South Carolina,31,18,13,0.581,6225,811,1913,600,1246,211,667,367,547,401,786,1187,435,243,157,472,602,2200,0.424,0.482,0.316,0.671,0.506,0.479
456,2020-21,South Carolina,21,6,15,0.286,4200,566,1364,424,898,142,466,249,381,268,487,755,280,176,77,313,401,1523,0.415,0.472,0.305,0.654,0.493,0.467
457,2019-20,South Carolina,31,18,13,0.581,6225,832,1890,658,1329,174,561,437,696,370,788,1158,445,240,134,407,723,2275,0.44,0.495,0.31,0.628,0.512,0.486
458,2023-24,South Alabama,32,16,16,0.5,6500,835,1886,596,1194,239,692,458,611,254,803,1057,341,216,88,362,532,2367,0.443,0.499,0.345,0.75,0.544,0.506
459,2022-23,South Alabama,35,19,16,0.543,7025,955,2036,689,1266,266,770,307,447,242,901,1143,399,212,151,342,512,2483,0.469,0.544,0.345,0.687,0.552,0.534
460,2021-22,South Alabama,33,21,12,0.636,6650,863,1877,639,1212,224,665,412,595,320,817,1137,393,230,161,416,542,2362,0.46,0.527,0.337,0.692,0.547,0.519
461,2020-21,South Alabama,28,17,11,0.607,5675,715,1621,459,914,256,707,389,542,269,727,996,314,200,91,333,434,2075,0.441,0.502,0.362,0.718,0.552,0.52
462,2019-20,South Alabama,31,20,11,0.645,6225,782,1662,616,1160,166,502,479,661,259,760,1019,346,238,115,374,499,2209,0.471,0.531,0.331,0.725,0.559,0.52
463,2023-24,SMU,33,20,13,0.606,6625,934,2089,683,1354,251,735,416,606,480,834,1314,517,277,159,372,564,2535,0.447,0.504,0.341,0.686,0.533,0.507
464,2022-23,SMU,32,10,22,0.313,6502,810,1919,609,1273,201,646,427,634,335,783,1118,436,226,108,413,556,2248,0.422,0.478,0.311,0.674,0.506,0.474
465,2021-22,SMU,33,24,9,0.727,6625,827,1878,547,1086,280,792,502,669,313,933,1246,457,207,142,407,502,2436,0.44,0.504,0.354,0.75,0.555,0.515
466,2020-21,SMU,17,11,6,0.647,3400,456,999,326,628,130,371,227,312,176,448,624,260,104,77,238,298,1269,0.456,0.519,0.35,0.728,0.553,0.522
467,2019-20,SMU,30,19,11,0.633,6125,770,1706,534,976,236,730,412,541,344,755,1099,467,175,96,400,491,2188,0.451,0.547,0.323,0.762,0.557,0.521
468,2023-24,SIU Edwardsville,33,17,16,0.515,6600,832,1965,593,1245,239,720,457,631,375,800,1175,374,226,137,352,550,2360,0.423,0.476,0.332,0.724,0.521,0.484
469,2022-23,SIU Edwardsville,33,19,14,0.576,6600,834,1917,598,1199,236,718,559,767,372,850,1222,407,228,141,421,576,2463,0.435,0.499,0.329,0.729,0.54,0.497
470,2021-22,SIU Edwardsville,32,11,21,0.344,6475,772,1848,584,1202,188,646,429,621,410,786,1196,394,228,122,482,584,2161,0.418,0.486,0.291,0.691,0.504,0.469
471,2020-21,SIU Edwardsville,26,9,17,0.346,5200,619,1403,463,913,156,490,315,463,226,626,852,337,153,121,413,438,1709,0.441,0.507,0.318,0.68,0.527,0.497
472,2019-20,SIU Edwardsville,31,8,23,0.258,6200,769,1801,593,1239,176,562,359,526,305,758,1063,428,177,91,436,607,2073,0.427,0.479,0.313,0.683,0.505,0.476
473,2023-24,Siena,32,4,28,0.125,6400,702,1758,533,1155,169,603,361,541,375,757,1132,342,164,130,505,491,1934,0.399,0.461,0.28,0.667,0.48,0.447
474,2022-23,Siena,32,17,15,0.531,6475,766,1769,553,1158,213,611,450,611,323,775,1098,409,182,135,420,547,2195,0.433,0.478,0.349,0.736,0.533,0.493
475,2021-22,Siena,29,15,14,0.517,5875,691,1621,495,1070,196,551,344,469,240,715,955,291,180,116,364,464,1922,0.426,0.463,0.356,0.733,0.521,0.487
476,2020-21,Siena,17,12,5,0.706,3400,411,894,303,580,108,314,219,333,152,442,594,215,94,56,219,264,1149,0.46,0.522,0.344,0.658,0.546,0.52
477,2019-20,Siena,30,20,10,0.667,6075,770,1679,572,1121,198,558,429,609,321,775,1096,401,160,92,389,495,2167,0.459,0.51,0.355,0.704,0.55,0.518
478,2023-24,Seton Hall,37,25,12,0.676,7500,987,2184,758,1503,229,681,527,674,445,934,1379,481,280,179,466,562,2730,0.452,0.504,0.336,0.782,0.545,0.504
479,2022-23,Seton Hall,33,17,16,0.515,6600,784,1785,594,1200,190,585,498,726,349,808,1157,401,272,143,454,586,2256,0.439,0.495,0.325,0.686,0.53,0.492
480,2021-22,Seton Hall,32,21,11,0.656,6425,808,1925,574,1233,234,692,452,600,387,846,1233,330,226,173,388,500,2302,0.42,0.466,0.338,0.753,0.521,0.481
481,2020-21,Seton Hall,27,14,13,0.519,5475,673,1525,493,964,180,561,398,544,276,665,941,347,170,118,350,442,1924,0.441,0.511,0.321,0.732,0.539,0.5
482,2019-20,Seton Hall,30,21,9,0.7,6000,783,1754,545,1043,238,711,437,611,308,805,1113,437,210,174,398,557,2241,0.446,0.523,0.335,0.715,0.548,0.514
483,2023-24,Seattle,37,23,14,0.622,7550,956,2143,675,1332,281,811,537,730,373,996,1369,481,215,106,470,683,2730,0.446,0.507,0.346,0.736,0.548,0.512
484,2022-23,Seattle,32,20,12,0.625,6425,786,1953,511,1083,275,870,456,635,359,827,1186,381,196,99,382,581,2303,0.402,0.472,0.316,0.718,0.511,0.473
485,2021-22,Seattle,32,23,9,0.719,6425,829,1989,520,1079,309,910,426,556,319,884,1203,436,221,116,371,657,2395,0.417,0.482,0.34,0.766,0.531,0.494
486,2020-21,Seattle,23,12,11,0.522,4625,593,1426,407,833,186,593,305,416,238,538,776,264,151,80,246,434,1677,0.416,0.489,0.314,0.733,0.516,0.481
487,2019-20,Seattle,29,14,15,0.483,5925,731,1800,522,1121,209,679,506,653,301,727,1028,316,171,90,297,581,2177,0.406,0.466,0.308,0.775,0.516,0.464
488,2023-24,Santa Clara,33,20,13,0.606,6625,912,1984,641,1218,271,766,443,620,397,899,1296,497,158,89,422,584,2538,0.46,0.526,0.354,0.715,0.557,0.528
489,2022-23,Santa Clara,33,23,10,0.697,6675,919,2026,644,1284,275,742,425,604,351,910,1261,460,196,125,414,519,2538,0.454,0.502,0.371,0.704,0.549,0.521
490,2021-22,Santa Clara,33,21,12,0.636,6625,950,1961,712,1332,238,629,412,541,246,926,1172,499,197,124,381,495,2550,0.484,0.535,0.378,0.762,0.575,0.545
491,2020-21,Santa Clara,20,12,8,0.6,4000,486,1121,376,762,110,359,311,455,164,565,729,240,88,78,260,357,1393,0.434,0.493,0.306,0.684,0.521,0.483
492,2019-20,Santa Clara,33,20,13,0.606,6625,877,1898,628,1194,249,704,495,667,241,887,1128,507,226,110,443,668,2498,0.462,0.526,0.354,0.742,0.564,0.528
493,2023-24,San Jose State,32,9,23,0.281,6450,832,1856,565,1078,267,778,297,423,252,734,986,433,165,106,336,547,2228,0.448,0.524,0.343,0.702,0.542,0.52
494,2022-23,San Jose State,35,21,14,0.6,7075,869,1996,604,1182,265,814,359,529,423,912,1335,428,142,145,416,545,2362,0.435,0.511,0.326,0.679,0.526,0.502
495,2021-22,San Jose State,31,8,23,0.258,6225,734,1717,461,942,273,775,252,383,236,729,965,404,162,98,409,506,1993,0.427,0.489,0.352,0.658,0.525,0.507
496,2020-21,San Jose State,21,5,16,0.238,4200,493,1257,336,763,157,494,238,364,173,549,722,213,99,57,265,349,1381,0.392,0.44,0.318,0.654,0.483,0.455
497,2019-20,San Jose State,31,7,24,0.226,6225,728,1871,471,1010,257,861,454,634,302,773,1075,404,199,102,430,567,2167,0.389,0.466,0.298,0.716,0.499,0.458
498,2023-24,San Francisco,34,23,11,0.676,6850,995,2044,702,1219,293,825,360,477,320,839,1159,554,279,117,392,622,2643,0.487,0.576,0.355,0.755,0.582,0.558
499,2022-23,San Francisco,34,20,14,0.588,6850,883,1975,534,1009,349,966,476,635,326,847,1173,436,230,85,469,629,2591,0.447,0.529,0.361,0.75,0.569,0.535
500,2021-22,San Francisco,34,24,10,0.706,6825,944,2064,617,1130,327,934,415,598,361,926,1287,443,261,158,434,615,2630,0.457,0.546,0.35,0.694,0.56,0.537
501,2020-21,San Francisco,25,11,14,0.44,5000,647,1515,388,753,259,762,233,324,226,605,831,298,179,83,292,483,1786,0.427,0.515,0.34,0.719,0.535,0.513
502,2019-20,San Francisco,34,22,12,0.647,6875,906,2050,606,1151,300,899,434,603,359,875,1234,410,239,106,412,600,2546,0.442,0.526,0.334,0.72,0.545,0.515
503,2023-24,San Diego State,37,26,11,0.703,7525,954,2167,695,1345,259,822,575,784,432,966,1398,481,275,149,413,647,2742,0.44,0.517,0.315,0.733,0.54,0.5
504,2022-23,San Diego State,39,32,7,0.821,7850,986,2251,715,1473,271,778,532,737,426,990,1416,504,262,151,452,634,2775,0.438,0.485,0.348,0.722,0.533,0.498
505,2021-22,San Diego State,32,23,9,0.719,6475,761,1761,569,1219,192,542,379,548,315,806,1121,382,239,152,409,559,2093,0.432,0.467,0.354,0.692,0.518,0.487
506,2020-21,San Diego State,28,23,5,0.821,5625,719,1596,479,945,240,651,384,534,274,729,1003,390,229,78,310,515,2062,0.451,0.507,0.369,0.719,0.557,0.526
507,2019-20,San Diego State,32,30,2,0.938,6400,852,1820,561,1055,291,765,400,519,297,824,1121,473,221,88,344,534,2395,0.468,0.532,0.38,0.771,0.579,0.548
508,2023-24,San Diego,33,18,15,0.545,6600,849,1978,616,1301,233,677,461,633,331,797,1128,432,239,126,437,628,2392,0.429,0.473,0.344,0.728,0.525,0.488
509,2022-23,San Diego,31,11,20,0.355,6250,849,1882,605,1191,244,691,449,587,314,713,1027,398,207,55,355,547,2391,0.451,0.508,0.353,0.765,0.553,0.516
510,2021-22,San Diego,31,15,16,0.484,6250,770,1797,600,1289,170,508,331,463,297,816,1113,308,157,114,386,493,2041,0.428,0.465,0.335,0.715,0.506,0.476
511,2020-21,San Diego,14,3,11,0.214,2825,352,847,270,577,82,270,141,217,112,357,469,185,94,48,185,252,927,0.416,0.468,0.304,0.65,0.488,0.464
512,2019-20,San Diego,32,9,23,0.281,6475,760,1843,564,1210,196,633,385,572,285,777,1062,387,186,107,464,581,2101,0.412,0.466,0.31,0.673,0.497,0.466
513,2023-24,Samford,35,29,6,0.829,7000,1054,2152,703,1263,351,889,553,765,371,881,1252,619,347,131,455,667,3012,0.49,0.557,0.395,0.723,0.599,0.571
514,2022-23,Samford,32,21,11,0.656,6502,832,1833,542,1011,290,822,565,756,319,818,1137,374,260,83,405,598,2519,0.454,0.536,0.353,0.747,0.575,0.533
515,2021-22,Samford,32,21,11,0.656,6450,856,1921,575,1085,281,836,397,544,340,799,1139,411,238,94,440,564,2390,0.446,0.53,0.336,0.73,0.548,0.519
516,2020-21,Samford,19,6,13,0.316,3875,541,1218,390,734,151,484,227,331,222,533,755,283,129,47,308,397,1460,0.444,0.531,0.312,0.686,0.531,0.506
517,2019-20,Samford,33,10,23,0.303,6650,862,1996,643,1338,219,658,505,679,352,856,1208,391,232,110,513,534,2448,0.432,0.481,0.333,0.744,0.528,0.487
518,2023-24,Sam Houston State,33,21,12,0.636,6650,828,1948,583,1251,245,697,480,663,393,862,1255,425,226,75,435,596,2381,0.425,0.466,0.352,0.724,0.526,0.488
519,2022-23,Sam Houston State,34,26,8,0.765,6850,894,1961,617,1230,277,731,389,575,388,862,1250,460,279,76,446,606,2454,0.456,0.502,0.379,0.677,0.549,0.527
520,2021-22,Sam Houston State,33,19,14,0.576,6625,846,1984,559,1147,287,837,293,484,345,889,1234,466,251,81,416,594,2272,0.426,0.487,0.343,0.605,0.513,0.499
521,2020-21,Sam Houston State,28,19,9,0.679,5600,797,1758,542,1043,255,715,380,549,320,713,1033,435,237,88,402,565,2229,0.453,0.52,0.357,0.692,0.552,0.526
522,2019-20,Sam Houston State,31,18,13,0.581,6325,874,1937,638,1247,236,690,433,584,315,745,1060,491,287,91,443,642,2417,0.451,0.512,0.342,0.741,0.546,0.512
523,2023-24,Saint Peter's,33,19,14,0.576,6625,720,1830,528,1240,192,590,508,713,411,750,1161,350,235,137,414,640,2140,0.393,0.426,0.325,0.712,0.493,0.446
524,2022-23,Saint Peter's,32,14,18,0.438,6450,716,1830,526,1182,190,648,364,528,433,686,1119,336,200,102,393,681,1986,0.391,0.445,0.293,0.689,0.477,0.443
525,2021-22,Saint Peter's,34,22,12,0.647,6850,797,1865,599,1299,198,566,485,692,366,852,1218,418,240,170,456,669,2277,0.427,0.461,0.35,0.701,0.519,0.48
526,2020-21,Saint Peter's,25,14,11,0.56,5000,555,1386,401,909,154,477,316,453,275,651,926,292,201,133,371,500,1580,0.4,0.441,0.323,0.698,0.493,0.456
527,2019-20,Saint Peter's,30,18,12,0.6,6025,674,1665,489,1124,185,541,457,632,376,747,1123,316,223,138,482,629,1990,0.405,0.435,0.342,0.723,0.506,0.46
528,2023-24,Saint Louis,33,13,20,0.394,6600,845,1873,586,1168,259,705,524,699,287,820,1107,426,200,101,388,596,2473,0.451,0.502,0.367,0.75,0.561,0.52
529,2022-23,Saint Louis,33,21,12,0.636,6600,921,1970,691,1325,230,645,421,576,335,919,1254,543,166,132,399,558,2493,0.468,0.522,0.357,0.731,0.556,0.526
530,2021-22,Saint Louis,35,23,12,0.657,7075,958,2090,722,1450,236,640,514,674,415,936,1351,517,225,109,450,627,2666,0.458,0.498,0.369,0.763,0.553,0.515
531,2020-21,Saint Louis,21,14,7,0.667,4200,586,1269,449,875,137,394,266,378,259,547,806,369,155,69,255,358,1575,0.462,0.513,0.348,0.704,0.544,0.516
532,2019-20,Saint Louis,31,23,8,0.742,6275,819,1804,653,1316,166,488,419,723,385,847,1232,450,232,130,396,569,2223,0.454,0.496,0.34,0.58,0.518,0.5
533,2023-24,Saint Joseph's,35,21,14,0.6,7050,928,2084,577,1088,351,996,434,598,353,900,1253,513,247,133,401,534,2641,0.445,0.53,0.352,0.726,0.558,0.53
534,2022-23,Saint Joseph's,33,16,17,0.485,6650,818,1920,528,1038,290,882,462,657,342,800,1142,399,216,107,421,578,2388,0.426,0.509,0.329,0.703,0.535,0.502
535,2021-22,Saint Joseph's,30,11,19,0.367,6050,747,1774,479,977,268,797,266,407,292,836,1128,406,148,74,406,484,2028,0.421,0.49,0.336,0.654,0.515,0.497
536,2020-21,Saint Joseph's,20,5,15,0.25,4125,506,1238,315,629,191,609,240,331,165,510,675,287,120,36,281,358,1443,0.409,0.501,0.314,0.725,0.517,0.486
537,2019-20,Saint Joseph's,32,6,26,0.188,6425,761,1942,474,976,287,966,399,566,327,795,1122,400,151,90,414,555,2208,0.392,0.486,0.297,0.705,0.499,0.466
538,2023-24,Saint Francis (PA),30,8,22,0.267,6025,713,1682,520,1106,193,576,336,551,357,681,1038,367,178,107,412,532,1955,0.424,0.47,0.335,0.61,0.503,0.481
539,2022-23,Saint Francis (PA),31,13,18,0.419,6225,813,1760,573,1127,240,633,397,564,265,772,1037,430,137,64,391,510,2263,0.462,0.508,0.379,0.704,0.558,0.53
540,2021-22,Saint Francis (PA),30,9,21,0.3,6075,764,1808,587,1246,177,562,353,545,356,743,1099,389,197,83,378,442,2058,0.423,0.471,0.315,0.648,0.498,0.472
541,2020-21,Saint Francis (PA),22,6,16,0.273,4450,541,1266,412,849,129,417,304,426,228,551,779,282,127,47,312,378,1515,0.427,0.485,0.309,0.714,0.516,0.478
542,2019-20,Saint Francis (PA),32,22,10,0.688,6425,899,1923,695,1356,204,567,483,644,353,804,1157,374,224,86,390,533,2485,0.467,0.513,0.36,0.75,0.557,0.521
543,2023-24,Sacred Heart,32,16,16,0.5,6400,864,1898,627,1248,237,650,407,586,300,779,1079,440,279,161,373,540,2372,0.455,0.502,0.365,0.695,0.545,0.518
544,2022-23,Sacred Heart,33,16,17,0.485,6650,864,2002,635,1271,229,731,375,553,349,831,1180,444,259,108,438,502,2332,0.432,0.5,0.313,0.678,0.515,0.489
545,2021-22,Sacred Heart,30,10,20,0.333,6050,807,1812,565,1106,242,706,324,447,337,749,1086,436,164,66,416,469,2180,0.445,0.511,0.343,0.725,0.538,0.512
546,2020-21,Sacred Heart,18,9,9,0.5,3675,431,1046,288,612,143,434,260,351,195,452,647,241,88,38,233,299,1265,0.412,0.471,0.329,0.741,0.522,0.48
547,2019-20,Sacred Heart,33,20,13,0.606,6600,843,1961,592,1193,251,768,483,658,435,926,1361,435,164,134,459,522,2420,0.43,0.496,0.327,0.734,0.532,0.494
548,2023-24,Sacramento State,34,10,24,0.294,6800,798,1855,540,1075,258,780,428,598,399,810,1209,444,178,93,495,577,2282,0.43,0.502,0.331,0.716,0.533,0.5
549,2022-23,Sacramento State,32,14,18,0.438,6525,778,1751,561,1122,217,629,341,489,348,793,1141,436,143,85,427,497,2114,0.444,0.5,0.345,0.697,0.533,0.506
550,2021-22,Sacramento State,29,11,18,0.379,5825,696,1615,500,1069,196,546,310,457,225,678,903,319,173,82,321,498,1898,0.431,0.468,0.359,0.678,0.518,0.492
551,2020-21,Sacramento State,20,8,12,0.4,4075,531,1157,398,795,133,362,248,365,187,440,627,255,138,45,202,356,1443,0.459,0.501,0.367,0.679,0.542,0.516
552,2019-20,Sacramento State,30,16,14,0.533,6000,685,1650,534,1181,151,469,374,520,335,709,1044,379,207,120,371,527,1895,0.415,0.452,0.322,0.719,0.499,0.461
553,2023-24,Rutgers,32,15,17,0.469,6425,750,1927,575,1317,175,610,417,634,392,796,1188,377,247,167,365,541,2092,0.389,0.437,0.287,0.658,0.469,0.435
554,2022-23,Rutgers,34,19,15,0.559,6850,867,2012,672,1404,195,608,397,567,394,857,1251,512,297,131,388,543,2326,0.431,0.479,0.321,0.7,0.51,0.479
555,2021-22,Rutgers,32,18,14,0.563,6500,826,1856,627,1269,199,587,341,487,327,814,1141,486,225,128,369,504,2192,0.445,0.494,0.339,0.7,0.525,0.499
556,2020-21,Rutgers,28,16,12,0.571,5625,741,1652,569,1101,172,551,285,448,272,716,988,384,213,144,321,490,1939,0.449,0.517,0.312,0.636,0.52,0.501
557,2019-20,Rutgers,31,20,11,0.645,6250,825,1847,653,1293,172,554,346,537,365,880,1245,394,203,142,379,520,2168,0.447,0.505,0.31,0.644,0.516,0.493
558,2023-24,Robert Morris,32,10,22,0.313,6498,833,1927,560,1115,273,812,387,540,391,768,1159,431,157,92,443,564,2326,0.432,0.502,0.336,0.717,0.533,0.503
559,2022-23,Robert Morris,33,16,17,0.485,6625,844,1904,609,1201,235,703,364,505,337,808,1145,457,220,135,432,533,2287,0.443,0.507,0.334,0.721,0.533,0.505
560,2021-22,Robert Morris,32,8,24,0.25,6450,823,1777,631,1210,192,567,382,503,286,757,1043,405,192,122,456,496,2220,0.463,0.521,0.339,0.759,0.551,0.517
561,2020-21,Robert Morris,19,4,15,0.211,3950,518,1169,376,775,142,394,196,299,207,439,646,299,124,57,254,348,1374,0.443,0.485,0.36,0.656,0.524,0.504
562,2019-20,Robert Morris,34,20,14,0.588,6800,874,1968,590,1185,284,783,341,508,348,793,1141,562,218,68,433,566,2373,0.444,0.498,0.363,0.671,0.537,0.516
563,2023-24,Rider,32,15,17,0.469,6475,836,1921,654,1381,182,540,455,608,362,840,1202,427,210,124,398,560,2309,0.435,0.474,0.337,0.748,0.522,0.483
564,2022-23,Rider,30,16,14,0.533,6075,793,1746,643,1297,150,449,369,502,339,746,1085,341,161,67,345,548,2105,0.454,0.496,0.334,0.735,0.53,0.497
565,2021-22,Rider,33,14,19,0.424,6675,826,1997,642,1425,184,572,401,545,360,863,1223,420,226,81,391,565,2237,0.414,0.451,0.322,0.736,0.496,0.46
566,2020-21,Rider,23,6,17,0.261,4625,564,1318,419,907,145,411,280,382,206,559,765,284,117,47,291,431,1553,0.428,0.462,0.353,0.733,0.518,0.483
567,2019-20,Rider,30,18,12,0.6,6000,755,1725,571,1151,184,574,458,704,328,821,1149,391,202,78,422,522,2152,0.438,0.496,0.321,0.651,0.522,0.491
568,2023-24,Richmond,33,23,10,0.697,6625,874,1889,632,1221,242,668,382,522,188,893,1081,436,220,97,285,468,2372,0.463,0.518,0.362,0.732,0.555,0.527
569,2022-23,Richmond,33,15,18,0.455,6700,786,1791,525,1001,261,790,440,591,226,841,1067,402,189,78,380,499,2273,0.439,0.524,0.33,0.745,0.549,0.512
570,2021-22,Richmond,37,24,13,0.649,7450,934,2112,644,1231,290,881,470,655,280,914,1194,536,281,87,361,513,2628,0.442,0.523,0.329,0.718,0.542,0.511
571,2020-21,Richmond,23,14,9,0.609,4600,624,1321,451,837,173,484,296,407,154,538,692,327,204,49,241,356,1717,0.472,0.539,0.357,0.727,0.567,0.538
572,2019-20,Richmond,31,24,7,0.774,6250,847,1817,598,1129,249,688,392,505,234,840,1074,481,252,78,338,479,2335,0.466,0.53,0.362,0.776,0.568,0.535
573,2023-24,Rice,32,11,21,0.344,6475,833,1880,582,1136,251,744,387,557,330,804,1134,461,178,117,372,463,2304,0.443,0.512,0.337,0.695,0.537,0.51
574,2022-23,Rice,35,19,16,0.543,7101,956,2052,648,1177,308,875,473,641,294,926,1220,533,208,85,450,541,2693,0.466,0.551,0.352,0.738,0.571,0.541
575,2021-22,Rice,33,16,17,0.485,6700,868,1892,571,1089,297,803,413,578,292,882,1174,513,169,60,413,460,2446,0.459,0.524,0.37,0.715,0.564,0.537
576,2020-21,Rice,28,15,13,0.536,5600,731,1660,445,860,286,800,320,438,264,772,1036,427,153,60,424,388,2068,0.44,0.517,0.358,0.731,0.554,0.527
577,2019-20,Rice,32,15,17,0.469,6400,800,1851,483,917,317,934,446,619,291,848,1139,454,190,67,427,524,2363,0.432,0.527,0.339,0.721,0.551,0.518
578,2023-24,Rhode Island,32,12,20,0.375,6400,826,1800,617,1201,209,599,461,713,332,846,1178,408,151,99,403,541,2322,0.459,0.514,0.349,0.647,0.543,0.517
579,2022-23,Rhode Island,31,9,22,0.29,6275,696,1765,528,1212,168,553,486,653,363,785,1148,347,199,119,437,557,2046,0.394,0.436,0.304,0.744,0.493,0.442
580,2021-22,Rhode Island,31,15,16,0.484,6200,769,1687,603,1194,166,493,377,608,299,825,1124,417,229,186,442,532,2081,0.456,0.505,0.337,0.62,0.527,0.505
581,2020-21,Rhode Island,25,10,15,0.4,5100,635,1436,492,978,143,458,373,558,266,696,962,303,164,114,353,444,1786,0.442,0.503,0.312,0.668,0.525,0.492
582,2019-20,Rhode Island,30,21,9,0.7,6050,783,1851,613,1312,170,539,464,686,359,803,1162,378,252,116,355,519,2200,0.423,0.467,0.315,0.676,0.505,0.469
583,2023-24,Radford,33,16,17,0.485,6675,871,1907,633,1252,238,655,397,537,339,804,1143,366,183,116,357,561,2377,0.457,0.506,0.363,0.739,0.55,0.519
584,2022-23,Radford,36,21,15,0.583,7225,931,2023,696,1369,235,654,399,579,370,832,1202,426,252,103,426,606,2496,0.46,0.508,0.359,0.689,0.543,0.518
585,2021-22,Radford,29,11,18,0.379,5875,666,1607,465,952,201,655,299,447,294,672,966,316,192,44,400,519,1832,0.414,0.488,0.307,0.669,0.503,0.477
586,2020-21,Radford,27,15,12,0.556,5500,644,1408,486,904,158,504,380,558,297,703,1000,301,164,48,403,425,1826,0.457,0.538,0.313,0.681,0.546,0.513
587,2019-20,Radford,32,21,11,0.656,6425,841,1813,590,1106,251,707,369,575,340,826,1166,427,170,68,342,561,2302,0.464,0.533,0.355,0.642,0.552,0.533
588,2023-24,Quinnipiac,34,24,10,0.706,6825,938,2089,684,1366,254,723,500,645,369,887,1256,479,260,125,423,552,2630,0.449,0.501,0.351,0.775,0.549,0.51
589,2022-23,Quinnipiac,32,20,12,0.625,6475,826,1908,563,1183,263,725,420,630,365,832,1197,419,196,82,404,525,2335,0.433,0.476,0.363,0.667,0.529,0.502
590,2021-22,Quinnipiac,31,14,17,0.452,6225,789,1830,513,1029,276,801,372,486,306,790,1096,446,197,66,402,518,2226,0.431,0.499,0.345,0.765,0.54,0.507
591,2020-21,Quinnipiac,22,9,13,0.409,4475,505,1258,336,736,169,522,306,445,170,623,793,279,123,100,313,420,1485,0.401,0.457,0.324,0.688,0.505,0.469
592,2019-20,Quinnipiac,30,15,15,0.5,6000,707,1695,397,826,310,869,364,478,277,814,1091,409,137,112,411,456,2088,0.417,0.481,0.357,0.762,0.543,0.509
593,2023-24,Queens (NC),33,14,19,0.424,6600,928,2095,634,1231,294,864,493,694,372,848,1220,435,230,91,377,573,2643,0.443,0.515,0.34,0.71,0.545,0.513
594,2022-23,Queens (NC),33,18,15,0.545,6600,878,1977,573,1104,305,873,503,698,371,861,1232,456,204,72,411,531,2564,0.444,0.519,0.349,0.721,0.555,0.521
595,2023-24,Purdue Fort Wayne,36,23,13,0.639,7250,1043,2231,703,1289,340,942,460,654,302,871,1173,490,332,111,375,612,2886,0.468,0.545,0.361,0.703,0.568,0.544
596,2022-23,Purdue Fort Wayne,32,17,15,0.531,6429,836,1906,528,1015,308,891,384,545,318,821,1139,418,235,74,421,467,2364,0.439,0.52,0.346,0.705,0.546,0.519
597,2021-22,Purdue Fort Wayne,33,21,12,0.636,6700,864,1888,553,1049,311,839,385,515,248,771,1019,465,289,82,443,503,2424,0.458,0.527,0.371,0.748,0.568,0.54
598,2020-21,Purdue Fort Wayne,23,8,15,0.348,4775,631,1259,427,749,204,510,262,380,177,544,721,328,156,64,393,413,1728,0.501,0.57,0.4,0.689,0.6,0.582
599,2019-20,Purdue Fort Wayne,33,14,19,0.424,6600,830,1945,556,1078,274,867,327,488,340,825,1165,417,245,89,456,520,2261,0.427,0.516,0.316,0.67,0.519,0.497
600,2023-24,Purdue,39,34,5,0.872,7875,1109,2272,791,1484,318,788,675,938,476,1101,1577,720,212,142,442,536,3211,0.488,0.533,0.404,0.72,0.591,0.558
601,2022-23,Purdue,35,29,6,0.829,7025,884,1936,645,1193,239,743,536,720,430,924,1354,542,166,129,388,479,2543,0.457,0.541,0.322,0.744,0.558,0.518
602,2021-22,Purdue,37,29,8,0.784,7475,1026,2094,711,1274,315,820,569,800,412,1019,1431,601,172,128,436,535,2936,0.49,0.558,0.384,0.711,0.593,0.565
603,2020-21,Purdue,28,18,10,0.643,5650,714,1596,513,993,201,603,360,506,312,742,1054,399,142,98,350,491,1989,0.447,0.517,0.333,0.711,0.542,0.51
604,2019-20,Purdue,31,16,15,0.516,6350,780,1867,557,1192,223,675,331,482,394,750,1144,423,202,109,357,544,2114,0.418,0.467,0.33,0.687,0.504,0.478
605,2023-24,Providence,35,21,14,0.6,7075,891,2011,601,1120,290,891,462,640,321,936,1257,477,225,161,424,552,2534,0.443,0.537,0.325,0.722,0.547,0.515
606,2022-23,Providence,33,21,12,0.636,6725,901,1975,683,1345,218,630,532,717,400,857,1257,482,226,147,387,495,2552,0.456,0.508,0.346,0.742,0.551,0.511
607,2021-22,Providence,33,27,6,0.818,6725,808,1859,565,1153,243,706,501,688,348,893,1241,437,166,121,377,527,2360,0.435,0.49,0.344,0.728,0.54,0.5
608,2020-21,Providence,26,13,13,0.5,5300,657,1529,493,1016,164,513,338,483,275,653,928,350,147,78,306,441,1816,0.43,0.485,0.32,0.7,0.516,0.483
609,2019-20,Providence,31,19,12,0.613,6225,764,1852,539,1174,225,678,461,664,406,766,1172,445,257,102,417,581,2214,0.413,0.459,0.332,0.694,0.511,0.473
610,2023-24,Princeton,29,24,5,0.828,5800,777,1695,473,841,304,854,377,468,244,722,966,422,173,55,237,392,2235,0.458,0.562,0.356,0.806,0.583,0.548
611,2022-23,Princeton,32,23,9,0.719,6475,867,1906,595,1110,272,796,410,576,325,923,1248,430,156,106,385,512,2416,0.455,0.536,0.342,0.712,0.554,0.526
612,2021-22,Princeton,30,23,7,0.767,6075,910,1866,583,1020,327,846,248,388,268,798,1066,464,186,54,305,421,2395,0.488,0.572,0.387,0.639,0.584,0.575
613,2019-20,Princeton,27,14,13,0.519,5425,695,1501,460,842,235,659,306,417,217,652,869,363,173,59,340,424,1931,0.463,0.546,0.357,0.734,0.568,0.541
614,2023-24,Presbyterian,33,14,19,0.424,6650,897,1901,687,1272,210,629,465,701,312,787,1099,426,232,106,377,612,2469,0.472,0.54,0.334,0.663,0.553,0.527
615,2022-23,Presbyterian,32,5,27,0.156,6468,718,1709,527,1093,191,616,394,630,336,712,1048,344,176,98,430,617,2021,0.42,0.482,0.31,0.625,0.503,0.476
616,2021-22,Presbyterian,32,12,20,0.375,6625,794,1881,611,1204,183,677,399,592,391,749,1140,403,253,87,434,610,2170,0.422,0.507,0.27,0.674,0.502,0.471
617,2020-21,Presbyterian,22,7,15,0.318,4425,499,1199,371,781,128,418,285,416,248,491,739,235,154,49,334,440,1411,0.416,0.475,0.306,0.685,0.505,0.47
618,2019-20,Presbyterian,32,10,22,0.313,6450,768,1707,571,1096,197,611,422,592,279,793,1072,392,188,55,462,594,2155,0.45,0.521,0.322,0.713,0.542,0.508
619,2023-24,Prairie View A&M,31,10,21,0.323,6200,770,1831,621,1342,149,489,487,675,303,649,952,373,283,87,396,626,2176,0.421,0.463,0.305,0.721,0.506,0.461
620,2022-23,Prairie View A&M,32,13,19,0.406,6525,773,1914,582,1283,191,631,431,629,378,745,1123,352,242,112,438,610,2168,0.404,0.454,0.303,0.685,0.49,0.454
621,2021-22,Prairie View A&M,27,8,19,0.296,5475,648,1515,477,1020,171,495,410,583,297,648,945,309,229,83,471,573,1877,0.428,0.468,0.345,0.703,0.524,0.484
622,2020-21,Prairie View A&M,21,16,5,0.762,4200,567,1265,428,808,139,457,224,342,235,504,739,333,202,89,288,437,1497,0.448,0.53,0.304,0.655,0.524,0.503
623,2019-20,Prairie View A&M,32,19,13,0.594,6450,813,1836,662,1343,151,493,525,741,305,740,1045,465,277,89,464,705,2302,0.443,0.493,0.306,0.709,0.526,0.484
624,2023-24,Portland State,32,17,15,0.531,6447,809,1949,572,1219,237,730,447,652,375,806,1181,379,226,107,361,579,2302,0.415,0.469,0.325,0.686,0.51,0.476
625,2022-23,Portland State,31,12,19,0.387,6200,835,1865,601,1177,234,688,459,631,289,685,974,431,220,105,375,700,2363,0.448,0.511,0.34,0.727,0.546,0.51
626,2021-22,Portland State,31,14,17,0.452,6250,820,1905,629,1265,191,640,449,605,318,732,1050,352,289,102,384,614,2280,0.43,0.497,0.298,0.742,0.52,0.481
627,2020-21,Portland State,22,9,13,0.409,4425,532,1335,380,818,152,517,296,437,287,545,832,247,182,66,305,443,1512,0.399,0.465,0.294,0.677,0.49,0.455
628,2019-20,Portland State,32,18,14,0.563,6400,927,2070,719,1444,208,626,456,634,451,721,1172,432,277,132,409,587,2518,0.448,0.498,0.332,0.719,0.531,0.498
629,2023-24,Portland,33,12,21,0.364,6625,826,1891,534,1049,292,842,416,581,276,836,1112,446,136,72,394,490,2360,0.437,0.509,0.347,0.716,0.545,0.514
630,2022-23,Portland,33,14,19,0.424,6650,836,1837,519,992,317,845,577,774,268,814,1082,488,164,75,420,579,2566,0.455,0.523,0.375,0.745,0.582,0.541
631,2021-22,Portland,34,19,15,0.559,6825,858,1963,594,1209,264,754,544,688,280,951,1231,487,172,86,448,557,2524,0.437,0.491,0.35,0.791,0.551,0.504
632,2020-21,Portland,21,6,15,0.286,4225,488,1187,335,736,153,451,330,426,138,462,600,250,132,61,292,340,1459,0.411,0.455,0.339,0.775,0.525,0.476
633,2019-20,Portland,32,9,23,0.281,6450,758,1769,542,1136,216,633,394,582,219,801,1020,421,179,114,446,546,2126,0.428,0.477,0.341,0.677,0.52,0.49
634,2023-24,Pittsburgh,33,22,11,0.667,6600,873,1999,556,1112,317,887,432,610,376,847,1223,452,208,147,297,510,2495,0.437,0.5,0.357,0.708,0.545,0.516
635,2022-23,Pittsburgh,36,24,12,0.667,7200,930,2081,605,1178,325,903,519,684,364,937,1301,506,185,147,400,585,2704,0.447,0.514,0.36,0.759,0.562,0.525
636,2021-22,Pittsburgh,32,11,21,0.344,6400,675,1630,503,1082,172,548,447,642,317,766,1083,352,172,123,435,489,1969,0.414,0.465,0.314,0.696,0.509,0.467
637,2020-21,Pittsburgh,22,10,12,0.455,4400,554,1283,410,857,144,426,314,473,279,564,843,321,133,83,277,381,1566,0.432,0.478,0.338,0.664,0.519,0.488
638,2019-20,Pittsburgh,33,16,17,0.485,6625,755,1867,580,1275,175,592,467,655,396,733,1129,404,258,113,403,510,2152,0.404,0.455,0.296,0.713,0.494,0.451
639,2023-24,Pepperdine,33,13,20,0.394,6600,868,1924,643,1300,225,624,442,628,334,781,1115,438,169,90,370,537,2403,0.451,0.495,0.361,0.704,0.541,0.51
640,2022-23,Pepperdine,31,9,22,0.29,6300,898,1930,645,1231,253,699,368,518,286,823,1109,469,168,117,436,548,2417,0.465,0.524,0.362,0.71,0.555,0.531
641,2021-22,Pepperdine,32,7,25,0.219,6450,810,1937,578,1255,232,682,331,461,316,787,1103,473,181,75,471,572,2183,0.418,0.461,0.34,0.718,0.506,0.478
642,2020-21,Pepperdine,27,15,12,0.556,5500,744,1608,557,1035,187,573,401,511,218,731,949,440,175,87,354,513,2076,0.463,0.538,0.326,0.785,0.561,0.521
643,2019-20,Pepperdine,32,16,16,0.5,6525,840,1934,585,1208,255,726,506,639,311,793,1104,475,197,121,407,582,2441,0.434,0.484,0.351,0.792,0.545,0.5
644,2023-24,Pennsylvania,29,11,18,0.379,5901,781,1721,506,971,275,750,322,468,303,739,1042,428,173,67,323,431,2159,0.454,0.521,0.367,0.688,0.555,0.534
645,2022-23,Pennsylvania,30,17,13,0.567,6100,812,1749,568,1071,244,678,381,514,304,824,1128,444,166,96,382,543,2249,0.464,0.53,0.36,0.741,0.564,0.534
646,2021-22,Pennsylvania,28,12,16,0.429,5650,748,1677,522,1002,226,675,295,405,247,719,966,354,154,63,330,483,2017,0.446,0.521,0.335,0.728,0.539,0.513
647,2019-20,Pennsylvania,27,16,11,0.593,5425,741,1625,501,901,240,724,269,405,218,761,979,403,159,90,340,397,1991,0.456,0.556,0.331,0.664,0.548,0.53
648,2023-24,Penn State,33,16,17,0.485,6650,854,1951,599,1187,255,764,515,689,316,749,1065,417,275,112,366,603,2478,0.438,0.505,0.334,0.747,0.544,0.503
649,2022-23,Penn State,37,23,14,0.622,7525,978,2111,593,1116,385,995,332,449,227,978,1205,508,161,79,332,572,2673,0.463,0.531,0.387,0.739,0.575,0.554
650,2021-22,Penn State,31,14,17,0.452,6275,740,1712,491,983,249,729,274,373,287,808,1095,368,164,67,366,478,2003,0.432,0.499,0.342,0.735,0.53,0.505
651,2020-21,Penn State,25,11,14,0.44,5050,637,1562,416,908,221,654,321,435,305,608,913,335,198,59,286,446,1816,0.408,0.458,0.338,0.738,0.513,0.479
652,2019-20,Penn State,31,21,10,0.677,6200,832,1931,583,1166,249,765,414,598,348,852,1200,443,233,150,348,543,2327,0.431,0.5,0.325,0.692,0.525,0.495
653,2023-24,Pacific,32,6,26,0.188,6450,725,1762,522,1119,203,643,418,650,209,666,875,422,195,64,377,551,2071,0.411,0.466,0.316,0.643,0.5,0.469
654,2022-23,Pacific,33,15,18,0.455,6650,868,1920,571,1159,297,761,469,651,267,777,1044,419,179,85,389,628,2502,0.452,0.493,0.39,0.72,0.561,0.529
655,2021-22,Pacific,30,8,22,0.267,6025,710,1710,528,1138,182,572,374,545,242,743,985,343,192,77,369,496,1976,0.415,0.464,0.318,0.686,0.502,0.468
656,2020-21,Pacific,18,9,9,0.5,3675,479,1093,386,782,93,311,205,302,182,440,622,233,116,61,215,335,1256,0.438,0.494,0.299,0.679,0.508,0.481
657,2019-20,Pacific,33,23,10,0.697,6775,843,1872,663,1342,180,530,434,651,360,830,1190,383,189,129,400,633,2300,0.45,0.494,0.34,0.667,0.527,0.498
658,2023-24,Oregon State,32,13,19,0.406,6550,772,1745,576,1148,196,597,464,630,275,766,1041,355,192,119,395,593,2204,0.442,0.502,0.328,0.737,0.539,0.499
659,2022-23,Oregon State,32,11,21,0.344,6400,676,1647,484,1042,192,605,415,551,254,742,996,326,172,98,429,570,1959,0.41,0.464,0.317,0.753,0.513,0.469
660,2021-22,Oregon State,31,3,28,0.097,6300,795,1795,619,1243,176,552,351,495,280,675,955,376,185,94,389,544,2117,0.443,0.498,0.319,0.709,0.521,0.492
661,2020-21,Oregon State,33,20,13,0.606,6650,803,1842,573,1197,230,645,489,642,334,799,1133,480,191,116,383,620,2325,0.436,0.479,0.357,0.762,0.541,0.498
662,2019-20,Oregon State,31,18,13,0.581,6200,766,1667,577,1085,189,582,486,647,263,746,1009,455,192,151,357,497,2207,0.46,0.532,0.325,0.751,0.559,0.516
663,2023-24,Oregon,36,24,12,0.667,7267,982,2145,719,1367,263,778,494,687,357,881,1238,497,258,131,366,591,2721,0.458,0.526,0.338,0.719,0.551,0.519
664,2022-23,Oregon,36,21,15,0.583,7225,916,2043,660,1244,256,799,454,653,397,957,1354,477,201,175,440,529,2542,0.448,0.531,0.32,0.695,0.54,0.511
665,2021-22,Oregon,35,20,15,0.571,7050,936,2075,687,1327,249,748,411,605,367,861,1228,426,238,122,411,582,2532,0.451,0.518,0.333,0.679,0.536,0.511
666,2020-21,Oregon,29,21,7,0.75,5800,779,1652,545,1031,234,621,305,429,263,663,926,389,208,103,319,434,2097,0.472,0.529,0.377,0.711,0.565,0.542
667,2019-20,Oregon,31,24,7,0.774,6375,857,1825,588,1145,269,680,369,527,336,758,1094,446,241,102,368,538,2352,0.47,0.514,0.396,0.7,0.567,0.543
668,2023-24,Oral Roberts,31,12,19,0.387,6250,812,1846,527,1056,285,790,366,493,235,787,1022,341,175,106,300,534,2275,0.44,0.499,0.361,0.742,0.547,0.517
669,2022-23,Oral Roberts,35,30,5,0.857,7000,1058,2231,683,1204,375,1027,424,548,313,975,1288,514,237,188,329,453,2915,0.474,0.567,0.365,0.774,0.585,0.558
670,2021-22,Oral Roberts,31,19,12,0.613,6250,937,2052,577,1104,360,948,348,477,332,915,1247,364,171,130,307,476,2582,0.457,0.523,0.38,0.73,0.567,0.544
671,2020-21,Oral Roberts,29,18,11,0.621,5825,811,1805,488,955,323,850,407,496,237,769,1006,370,191,111,330,502,2352,0.449,0.511,0.38,0.821,0.576,0.539
672,2019-20,Oral Roberts,31,17,14,0.548,6250,898,2004,645,1246,253,758,436,582,364,811,1175,406,197,79,320,521,2485,0.448,0.518,0.334,0.749,0.545,0.511
673,2023-24,Omaha,33,15,18,0.455,6650,845,1873,639,1242,206,631,545,734,282,829,1111,336,200,73,326,552,2441,0.451,0.514,0.326,0.743,0.549,0.506
674,2022-23,Omaha,32,9,23,0.281,6425,797,1805,614,1265,183,540,415,535,259,778,1037,380,172,92,400,584,2192,0.442,0.485,0.339,0.776,0.532,0.492
675,2021-22,Omaha,30,5,25,0.167,6000,755,1751,543,1154,212,597,366,501,262,722,984,328,144,77,410,577,2088,0.431,0.471,0.355,0.731,0.525,0.492
676,2020-21,Omaha,25,5,20,0.2,5000,625,1494,492,1097,133,397,300,436,212,641,853,236,141,75,327,471,1683,0.418,0.448,0.335,0.688,0.495,0.463
677,2019-20,Omaha,32,16,16,0.5,6500,886,1973,686,1381,200,592,380,534,315,844,1159,393,166,105,391,532,2352,0.449,0.497,0.338,0.712,0.528,0.5
678,2023-24,Ole Miss,32,20,12,0.625,6400,839,1876,598,1216,241,660,479,658,333,738,1071,484,251,184,344,522,2398,0.447,0.492,0.365,0.728,0.548,0.511
679,2022-23,Ole Miss,33,12,21,0.364,6651,816,1933,613,1262,203,671,392,564,396,784,1180,432,235,123,402,525,2227,0.422,0.486,0.303,0.695,0.506,0.475
680,2021-22,Ole Miss,32,13,19,0.406,6475,793,1824,571,1144,222,680,372,523,296,774,1070,422,227,89,391,486,2180,0.435,0.499,0.326,0.711,0.526,0.496
681,2020-21,Ole Miss,28,16,12,0.571,5625,700,1587,554,1101,146,486,381,543,338,686,1024,342,211,109,392,481,1927,0.441,0.503,0.3,0.702,0.522,0.487
682,2019-20,Ole Miss,32,15,17,0.469,6450,769,1780,577,1180,192,600,478,655,288,792,1080,413,229,91,420,621,2208,0.432,0.489,0.32,0.73,0.528,0.486
683,2023-24,Old Dominion,32,7,25,0.219,6450,841,2001,620,1307,221,694,365,551,320,814,1134,330,251,123,349,581,2268,0.42,0.474,0.318,0.662,0.501,0.476
684,2022-23,Old Dominion,31,19,12,0.613,6225,735,1760,571,1237,164,523,439,646,375,800,1175,328,197,117,348,519,2073,0.418,0.462,0.314,0.68,0.501,0.464
685,2021-22,Old Dominion,32,13,19,0.406,6425,786,1810,645,1330,141,480,414,616,365,829,1194,395,205,105,381,508,2127,0.434,0.485,0.294,0.672,0.506,0.473
686,2020-21,Old Dominion,23,15,8,0.652,4625,586,1308,473,916,113,392,286,413,224,602,826,278,172,86,291,365,1571,0.448,0.516,0.288,0.692,0.522,0.491
687,2019-20,Old Dominion,32,13,19,0.406,6450,768,1898,584,1269,184,629,378,546,374,881,1255,340,217,89,393,545,2098,0.405,0.46,0.293,0.692,0.486,0.453
688,2023-24,Oklahoma State,32,12,20,0.375,6475,793,1799,533,1021,260,778,426,611,294,784,1078,428,200,92,413,511,2272,0.441,0.522,0.334,0.697,0.544,0.513
689,2022-23,Oklahoma State,36,20,16,0.556,7250,875,2046,628,1249,247,797,461,664,410,935,1345,452,204,174,507,611,2458,0.428,0.503,0.31,0.694,0.52,0.488
690,2021-22,Oklahoma State,30,15,15,0.5,6150,754,1737,593,1191,161,546,382,573,347,766,1113,380,256,163,453,522,2051,0.434,0.498,0.295,0.667,0.51,0.48
691,2020-21,Oklahoma State,30,21,9,0.7,6125,816,1780,626,1207,190,573,475,669,332,818,1150,385,224,132,467,516,2297,0.458,0.519,0.332,0.71,0.547,0.512
692,2019-20,Oklahoma State,32,18,14,0.563,6400,757,1783,568,1183,189,600,460,627,324,817,1141,379,218,121,426,572,2163,0.425,0.48,0.315,0.734,0.52,0.478
693,2023-24,Oklahoma,32,20,12,0.625,6450,835,1797,596,1105,239,692,503,677,310,816,1126,427,189,104,399,515,2412,0.465,0.539,0.345,0.743,0.569,0.531
694,2022-23,Oklahoma,32,15,17,0.469,6450,782,1707,558,1069,224,638,377,513,232,817,1049,417,183,97,428,518,2165,0.458,0.522,0.351,0.735,0.555,0.524
695,2021-22,Oklahoma,35,19,16,0.543,7100,885,1859,619,1092,266,767,381,510,268,846,1114,491,258,66,516,542,2417,0.476,0.567,0.347,0.747,0.575,0.548
696,2020-21,Oklahoma,27,16,11,0.593,5475,722,1630,510,1008,212,622,356,478,259,706,965,359,193,98,296,398,2012,0.443,0.506,0.341,0.745,0.542,0.508
697,2019-20,Oklahoma,31,19,12,0.613,6200,760,1808,536,1104,224,704,433,565,259,884,1143,365,190,135,345,415,2177,0.42,0.486,0.318,0.766,0.524,0.482
698,2023-24,Ohio State,36,22,14,0.611,7280,957,2126,703,1390,254,736,550,717,394,941,1335,507,201,166,381,611,2718,0.45,0.506,0.345,0.767,0.551,0.51
699,2022-23,Ohio State,35,16,19,0.457,7050,948,2052,709,1402,239,650,403,545,370,887,1257,410,181,132,375,573,2538,0.462,0.506,0.368,0.739,0.549,0.52
700,2021-22,Ohio State,32,20,12,0.625,6450,819,1740,568,1052,251,688,440,581,288,819,1107,400,144,152,358,525,2329,0.471,0.54,0.365,0.757,0.578,0.543
701,2020-21,Ohio State,31,21,10,0.677,6275,819,1786,567,1086,252,700,502,664,302,833,1135,406,140,108,329,571,2392,0.459,0.522,0.36,0.756,0.569,0.529
702,2019-20,Ohio State,31,21,10,0.677,6200,753,1690,492,990,261,700,467,621,308,832,1140,412,156,107,394,531,2234,0.446,0.497,0.373,0.752,0.563,0.523
703,2023-24,Ohio,33,20,13,0.606,6675,901,1987,607,1160,294,827,455,623,333,820,1153,464,235,118,321,562,2551,0.453,0.523,0.356,0.73,0.559,0.527
704,2022-23,Ohio,33,19,14,0.576,6625,945,2063,650,1272,295,791,417,571,399,840,1239,412,221,73,370,585,2602,0.458,0.511,0.373,0.73,0.557,0.53
705,2021-22,Ohio,35,25,10,0.714,7000,898,2084,582,1142,316,942,479,657,351,843,1194,441,263,91,368,505,2591,0.431,0.51,0.335,0.729,0.541,0.507
706,2020-21,Ohio,25,17,8,0.68,5000,728,1519,519,926,209,593,315,448,240,643,883,437,161,52,301,396,1980,0.479,0.56,0.352,0.703,0.572,0.548
707,2019-20,Ohio,32,17,15,0.531,6400,822,1837,550,1056,272,781,370,537,299,835,1134,471,205,73,406,532,2286,0.447,0.521,0.348,0.689,0.546,0.522
708,2023-24,Oakland,36,24,12,0.667,7325,966,2166,648,1271,318,895,501,667,383,909,1292,522,237,100,396,544,2751,0.446,0.51,0.355,0.751,0.554,0.519
709,2022-23,Oakland,32,13,19,0.406,6525,823,1892,591,1139,232,753,469,604,268,709,977,384,239,84,339,448,2347,0.435,0.519,0.308,0.776,0.539,0.496
710,2021-22,Oakland,32,20,12,0.625,6425,824,1876,589,1098,235,778,498,627,345,759,1104,428,289,77,392,437,2381,0.439,0.536,0.302,0.794,0.548,0.502
711,2020-21,Oakland,30,12,18,0.4,6200,773,1855,514,1077,259,778,435,616,346,708,1054,444,248,56,390,441,2240,0.417,0.477,0.333,0.706,0.522,0.487
712,2019-20,Oakland,33,14,19,0.424,6700,780,1822,576,1132,204,690,475,689,339,856,1195,448,192,99,453,524,2239,0.428,0.509,0.296,0.689,0.521,0.484
713,2023-24,Notre Dame,33,13,20,0.394,6675,742,1824,491,1034,251,790,378,508,324,861,1185,335,189,80,413,497,2113,0.407,0.475,0.318,0.744,0.512,0.476
714,2022-23,Notre Dame,32,11,21,0.344,6425,810,1830,528,1043,282,787,325,426,210,784,994,379,150,87,281,456,2227,0.443,0.506,0.358,0.763,0.548,0.52
715,2021-22,Notre Dame,35,24,11,0.686,7100,913,1973,595,1139,318,834,396,526,251,939,1190,491,182,65,365,446,2540,0.463,0.522,0.381,0.753,0.571,0.543
716,2020-21,Notre Dame,26,11,15,0.423,5200,679,1479,443,837,236,642,296,383,187,681,868,387,111,102,275,334,1890,0.459,0.529,0.368,0.773,0.569,0.539
717,2019-20,Notre Dame,32,20,12,0.625,6450,850,1993,540,1094,310,899,366,498,322,887,1209,528,189,118,315,397,2376,0.426,0.494,0.345,0.735,0.533,0.504
718,2023-24,Northwestern State,32,9,23,0.281,6500,808,1872,604,1229,204,643,437,663,365,742,1107,368,223,105,425,598,2257,0.432,0.491,0.317,0.659,0.516,0.486
719,2022-23,Northwestern State,33,22,11,0.667,6650,900,2024,622,1254,278,770,385,547,400,714,1114,415,273,79,393,605,2463,0.445,0.496,0.361,0.704,0.539,0.513
720,2021-22,Northwestern State,32,9,23,0.281,6400,895,2012,662,1331,233,681,340,490,351,795,1146,481,203,112,446,542,2363,0.445,0.497,0.342,0.694,0.526,0.503
721,2020-21,Northwestern State,29,11,18,0.379,5850,770,1788,560,1185,210,603,356,530,297,734,1031,376,202,85,419,544,2106,0.431,0.473,0.348,0.672,0.516,0.489
722,2019-20,Northwestern State,30,15,15,0.5,6025,797,1802,563,1144,234,658,437,596,335,832,1167,386,175,132,493,588,2265,0.442,0.492,0.356,0.733,0.543,0.507
723,2023-24,Northwestern,34,22,12,0.647,6925,892,1960,614,1247,278,713,431,573,290,778,1068,530,239,106,300,598,2493,0.455,0.492,0.39,0.752,0.558,0.526
724,2022-23,Northwestern,34,22,12,0.647,6850,801,1968,542,1161,259,807,442,584,350,824,1174,434,267,133,327,549,2303,0.407,0.467,0.321,0.757,0.513,0.473
725,2021-22,Northwestern,31,15,16,0.484,6300,824,1928,565,1182,259,746,355,494,295,805,1100,490,201,108,303,545,2262,0.427,0.478,0.347,0.719,0.523,0.495
726,2020-21,Northwestern,24,9,15,0.375,4850,607,1401,407,835,200,566,272,379,180,628,808,352,148,63,284,424,1686,0.433,0.487,0.353,0.718,0.533,0.505
727,2019-20,Northwestern,31,8,23,0.258,6250,743,1785,554,1180,189,605,337,461,240,806,1046,424,123,101,325,517,2012,0.416,0.469,0.312,0.731,0.502,0.469
728,2023-24,Northern Kentucky,33,18,15,0.545,6700,882,1935,673,1279,209,656,497,691,347,794,1141,456,284,86,407,543,2470,0.456,0.526,0.319,0.719,0.546,0.51
729,2022-23,Northern Kentucky,35,22,13,0.629,7125,851,1997,568,1170,283,827,387,556,394,742,1136,468,329,89,395,535,2372,0.426,0.485,0.342,0.696,0.525,0.497
730,2021-22,Northern Kentucky,32,20,12,0.625,6500,805,1877,525,1066,280,811,347,486,398,739,1137,440,290,80,421,488,2237,0.429,0.492,0.345,0.714,0.531,0.503
731,2020-21,Northern Kentucky,25,14,11,0.56,5075,658,1477,479,893,179,584,289,410,305,567,872,295,161,41,312,417,1784,0.445,0.536,0.307,0.705,0.534,0.506
732,2019-20,Northern Kentucky,32,23,9,0.719,6450,810,1872,551,1024,259,848,438,636,359,813,1172,435,259,66,399,574,2317,0.433,0.538,0.305,0.689,0.533,0.502
733,2023-24,Northern Iowa,33,19,14,0.576,6650,843,1849,605,1159,238,690,493,697,265,852,1117,414,206,85,340,547,2417,0.456,0.522,0.345,0.707,0.554,0.52
734,2022-23,Northern Iowa,32,14,18,0.438,6450,810,1788,572,1089,238,699,386,554,244,806,1050,372,204,45,385,498,2244,0.453,0.525,0.34,0.697,0.547,0.52
735,2021-22,Northern Iowa,32,20,12,0.625,6525,823,1793,545,1011,278,782,459,582,216,828,1044,377,184,45,356,444,2383,0.459,0.539,0.355,0.789,0.576,0.537
736,2020-21,Northern Iowa,25,10,15,0.4,5050,647,1461,461,889,186,572,258,378,229,661,890,329,161,64,326,380,1738,0.443,0.519,0.325,0.683,0.53,0.507
737,2019-20,Northern Iowa,31,25,6,0.806,6275,844,1776,557,1039,287,737,355,468,294,870,1164,379,143,71,372,443,2330,0.475,0.536,0.389,0.759,0.583,0.556
738,2023-24,Northern Illinois,31,11,20,0.355,6275,800,1802,573,1106,227,696,442,658,320,791,1111,317,164,153,394,539,2269,0.444,0.518,0.326,0.672,0.537,0.507
739,2022-23,Northern Illinois,32,13,19,0.406,6425,837,1816,601,1138,236,678,394,604,279,781,1060,402,207,74,458,617,2304,0.461,0.528,0.348,0.652,0.548,0.526
740,2021-22,Northern Illinois,30,9,21,0.3,6025,690,1646,515,1094,175,552,368,545,254,715,969,337,188,82,411,612,1923,0.419,0.471,0.317,0.675,0.505,0.472
741,2020-21,Northern Illinois,19,3,16,0.158,3825,456,1143,352,822,104,321,168,273,243,441,684,204,110,65,261,342,1184,0.399,0.428,0.324,0.615,0.465,0.444
742,2019-20,Northern Illinois,31,18,13,0.581,6225,751,1814,525,1153,226,661,343,509,361,834,1195,311,174,85,366,548,2071,0.414,0.455,0.342,0.674,0.504,0.476
743,2023-24,Northern Colorado,33,19,14,0.576,6800,969,1997,715,1267,254,730,425,583,270,887,1157,482,207,79,368,547,2617,0.485,0.564,0.348,0.729,0.575,0.549
744,2022-23,Northern Colorado,32,12,20,0.375,6452,826,1843,561,1102,265,741,438,588,263,805,1068,363,147,54,382,596,2355,0.448,0.509,0.358,0.745,0.555,0.52
745,2021-22,Northern Colorado,38,22,16,0.579,7675,1049,2209,660,1189,389,1020,475,670,288,1014,1302,467,151,110,470,655,2962,0.475,0.555,0.381,0.709,0.586,0.563
746,2020-21,Northern Colorado,22,11,11,0.5,4425,549,1221,350,693,199,528,254,381,175,583,758,242,95,59,309,397,1551,0.45,0.505,0.377,0.667,0.553,0.531
747,2019-20,Northern Colorado,31,22,9,0.71,6250,837,1790,520,964,317,826,312,468,261,794,1055,416,157,73,314,472,2303,0.468,0.539,0.384,0.667,0.572,0.556
748,2023-24,Northern Arizona,33,14,19,0.424,6650,825,1883,618,1220,207,663,408,586,274,760,1034,444,187,102,416,605,2265,0.438,0.507,0.312,0.696,0.524,0.493
749,2022-23,Northern Arizona,35,12,23,0.343,7100,930,2123,635,1308,295,815,426,576,354,835,1189,484,185,53,378,649,2581,0.438,0.485,0.362,0.74,0.538,0.508
750,2021-22,Northern Arizona,32,9,23,0.281,6450,770,1845,493,1072,277,773,344,518,334,841,1175,403,144,80,431,586,2161,0.417,0.46,0.358,0.664,0.517,0.492
751,2020-21,Northern Arizona,22,6,16,0.273,4425,505,1197,366,800,139,397,241,364,178,450,628,238,120,34,259,395,1390,0.422,0.458,0.35,0.662,0.507,0.48
752,2019-20,Northern Arizona,30,16,14,0.533,6025,770,1729,554,1129,216,600,372,531,285,736,1021,396,195,62,346,480,2128,0.445,0.491,0.36,0.701,0.537,0.508
753,2023-24,Northeastern,32,12,20,0.375,6400,810,1780,606,1138,204,642,397,531,326,736,1062,435,200,107,398,485,2221,0.455,0.533,0.318,0.748,0.546,0.512
754,2022-23,Northeastern,30,10,20,0.333,6050,712,1704,501,1069,211,635,324,473,331,750,1081,377,149,123,432,500,1959,0.418,0.469,0.332,0.685,0.508,0.48
755,2021-22,Northeastern,31,9,22,0.29,6250,709,1624,499,967,210,657,365,497,250,742,992,352,146,85,433,472,1993,0.437,0.516,0.32,0.734,0.536,0.501
756,2020-21,Northeastern,19,10,9,0.526,3825,457,1044,295,586,162,458,201,271,126,497,623,234,119,44,257,299,1277,0.438,0.503,0.354,0.742,0.544,0.515
757,2019-20,Northeastern,33,17,16,0.515,6625,856,1808,587,1082,269,726,366,463,240,779,1019,439,251,57,391,553,2347,0.473,0.543,0.371,0.79,0.579,0.548
758,2023-24,North Texas,34,19,15,0.559,6850,826,1907,542,1154,284,753,417,566,390,789,1179,378,241,101,378,571,2353,0.433,0.47,0.377,0.737,0.541,0.508
759,2022-23,North Texas,38,31,7,0.816,7700,854,1957,570,1148,284,809,460,609,407,882,1289,428,246,112,451,619,2452,0.436,0.497,0.351,0.755,0.546,0.509
760,2021-22,North Texas,32,25,7,0.781,6450,722,1632,475,941,247,691,392,603,333,758,1091,351,209,89,366,507,2083,0.442,0.505,0.357,0.65,0.543,0.518
761,2020-21,North Texas,28,18,10,0.643,5650,717,1516,503,945,214,571,306,411,238,689,927,373,182,81,360,440,1954,0.473,0.532,0.375,0.745,0.571,0.544
762,2019-20,North Texas,31,20,11,0.645,6225,786,1627,533,960,253,667,378,503,266,732,998,390,195,88,421,530,2203,0.483,0.555,0.379,0.751,0.59,0.561
763,2023-24,North Florida,32,16,16,0.5,6475,849,1917,466,854,383,1063,415,542,284,792,1076,398,179,116,362,517,2496,0.443,0.546,0.36,0.766,0.574,0.543
764,2022-23,North Florida,31,14,17,0.452,6300,837,1838,514,957,323,881,366,509,279,779,1058,405,154,120,378,435,2363,0.455,0.537,0.367,0.719,0.568,0.543
765,2021-22,North Florida,31,11,20,0.355,6250,725,1743,429,870,296,873,378,520,282,767,1049,394,172,149,453,486,2124,0.416,0.493,0.339,0.727,0.534,0.501
766,2020-21,North Florida,23,8,15,0.348,4600,570,1282,341,657,229,625,232,325,204,546,750,297,102,76,344,386,1601,0.445,0.519,0.366,0.714,0.557,0.534
767,2019-20,North Florida,33,21,12,0.636,6600,889,1975,498,944,391,1031,414,543,327,811,1138,517,164,125,390,530,2583,0.45,0.528,0.379,0.762,0.578,0.549
768,2023-24,North Dakota State,32,15,17,0.469,6575,873,1834,621,1167,252,667,390,543,271,826,1097,370,139,43,355,468,2388,0.476,0.532,0.378,0.718,0.571,0.545
769,2022-23,North Dakota State,33,16,17,0.485,6600,866,1904,619,1169,247,735,425,597,281,910,1191,370,130,98,379,509,2404,0.455,0.53,0.336,0.712,0.549,0.52
770,2021-22,North Dakota State,33,23,10,0.697,6700,867,1878,616,1177,251,701,484,636,275,959,1234,367,129,114,384,514,2469,0.462,0.523,0.358,0.761,0.566,0.528
771,2020-21,North Dakota State,27,15,12,0.556,5425,659,1491,475,951,184,540,381,501,256,742,998,285,105,69,338,430,1883,0.442,0.499,0.341,0.76,0.545,0.504
772,2019-20,North Dakota State,33,25,8,0.758,6625,837,1878,534,1026,303,852,490,614,254,919,1173,393,153,75,330,512,2467,0.446,0.52,0.356,0.798,0.569,0.526
773,2023-24,North Dakota,32,18,14,0.563,6425,858,1934,594,1125,264,809,428,600,366,805,1171,371,202,96,324,485,2408,0.444,0.528,0.326,0.713,0.543,0.512
774,2022-23,North Dakota,33,13,20,0.394,6650,858,1945,554,1077,304,868,360,527,304,797,1101,394,146,88,378,522,2380,0.441,0.514,0.35,0.683,0.542,0.519
775,2021-22,North Dakota,31,6,25,0.194,6225,739,1826,461,1020,278,806,422,575,310,789,1099,373,124,58,371,538,2178,0.405,0.452,0.345,0.734,0.519,0.481
776,2020-21,North Dakota,26,9,17,0.346,5275,623,1454,433,890,190,564,351,503,214,630,844,306,134,55,340,448,1787,0.428,0.487,0.337,0.698,0.528,0.494
777,2019-20,North Dakota,33,15,18,0.455,6650,855,1874,596,1112,259,762,501,658,284,888,1172,424,150,75,439,577,2470,0.456,0.536,0.34,0.761,0.565,0.525
778,2023-24,North Carolina Central,31,18,13,0.581,6250,823,1812,590,1131,233,681,496,714,349,748,1097,398,237,83,372,552,2375,0.454,0.522,0.342,0.695,0.552,0.518
779,2022-23,North Carolina Central,30,18,12,0.6,6100,815,1737,594,1123,221,614,417,594,328,745,1073,439,239,97,459,575,2268,0.469,0.529,0.36,0.702,0.562,0.533
780,2021-22,North Carolina Central,31,16,15,0.516,6275,809,1801,608,1195,201,606,437,654,362,757,1119,384,271,67,488,631,2256,0.449,0.509,0.332,0.668,0.534,0.505
781,2020-21,North Carolina Central,14,5,9,0.357,2825,333,791,238,511,95,280,181,261,130,328,458,169,102,39,205,293,942,0.421,0.466,0.339,0.693,0.515,0.481
782,2019-20,North Carolina Central,31,18,13,0.581,6300,797,1734,615,1129,182,605,386,591,301,763,1064,420,260,93,472,588,2162,0.46,0.545,0.301,0.653,0.537,0.512
783,2023-24,North Carolina A&T,32,7,25,0.219,6400,726,1873,534,1204,192,669,454,637,300,720,1020,326,180,104,300,488,2098,0.388,0.444,0.287,0.713,0.482,0.439
784,2022-23,North Carolina A&T,32,13,19,0.406,6449,806,1931,545,1146,261,785,391,574,300,836,1136,375,240,98,385,547,2264,0.417,0.476,0.332,0.681,0.514,0.485
785,2021-22,North Carolina A&T,32,12,20,0.375,6450,806,1899,604,1252,202,647,353,540,356,779,1135,392,249,103,406,611,2167,0.424,0.482,0.312,0.654,0.503,0.478
786,2020-21,North Carolina A&T,21,11,10,0.524,4225,536,1273,399,844,137,429,308,468,228,508,736,285,183,56,294,367,1517,0.421,0.473,0.319,0.658,0.507,0.475
787,2019-20,North Carolina A&T,32,17,15,0.531,6450,826,1920,645,1308,181,612,478,785,364,872,1236,471,260,117,490,668,2311,0.43,0.493,0.296,0.609,0.504,0.477
788,2023-24,North Carolina,37,29,8,0.784,7425,1046,2323,745,1484,301,839,639,842,452,1068,1520,536,214,151,373,611,3032,0.45,0.502,0.359,0.759,0.557,0.515
789,2022-23,North Carolina,33,20,13,0.606,6725,866,1997,632,1246,234,751,548,739,369,935,1304,397,177,128,355,555,2514,0.434,0.507,0.312,0.742,0.535,0.492
790,2021-22,North Carolina,39,29,10,0.744,7875,1076,2409,748,1492,328,917,558,730,447,1162,1609,582,202,153,455,564,3038,0.447,0.501,0.358,0.764,0.551,0.515
791,2020-21,North Carolina,29,18,11,0.621,5800,801,1826,639,1317,162,509,417,624,454,788,1242,443,204,137,423,486,2181,0.439,0.485,0.318,0.668,0.514,0.483
792,2019-20,North Carolina,33,14,19,0.424,6700,865,2058,684,1463,181,595,470,689,455,927,1382,472,183,116,426,550,2383,0.42,0.468,0.304,0.682,0.5,0.464
793,2023-24,North Alabama,32,15,17,0.469,6528,857,1931,611,1252,246,679,487,634,317,815,1132,359,171,101,324,589,2447,0.444,0.488,0.362,0.768,0.548,0.508
794,2022-23,North Alabama,33,18,15,0.545,6675,892,1949,640,1267,252,682,410,578,282,863,1145,378,193,101,373,552,2446,0.458,0.505,0.37,0.709,0.55,0.522
795,2021-22,North Alabama,30,9,21,0.3,6050,752,1903,504,1117,248,786,329,437,328,756,1084,304,205,104,357,559,2081,0.395,0.451,0.316,0.753,0.493,0.46
796,2020-21,North Alabama,24,13,11,0.542,4850,624,1457,432,888,192,569,316,424,263,673,936,272,141,77,332,423,1756,0.428,0.486,0.337,0.745,0.529,0.494
797,2019-20,North Alabama,30,13,17,0.433,6025,709,1666,501,1054,208,612,436,633,301,773,1074,331,195,71,444,590,2062,0.426,0.475,0.34,0.689,0.524,0.488
798,2023-24,Norfolk State,35,24,11,0.686,7025,908,1978,685,1322,223,656,569,788,384,821,1205,436,308,108,425,650,2608,0.459,0.518,0.34,0.722,0.554,0.515
799,2022-23,Norfolk State,33,22,11,0.667,6660,876,1854,651,1190,225,664,524,704,362,823,1185,424,234,122,434,598,2501,0.472,0.547,0.339,0.744,0.571,0.533
800,2021-22,Norfolk State,31,24,7,0.774,6200,814,1766,598,1137,216,629,458,655,319,873,1192,386,207,111,435,547,2302,0.461,0.526,0.343,0.699,0.554,0.522
801,2020-21,Norfolk State,25,17,8,0.68,5025,630,1477,436,949,194,528,385,546,248,659,907,302,163,80,322,481,1839,0.427,0.459,0.367,0.705,0.53,0.492
802,2019-20,Norfolk State,31,16,15,0.516,6225,754,1820,511,1068,243,752,435,611,356,795,1151,406,244,73,436,605,2186,0.414,0.478,0.323,0.712,0.518,0.481
803,2023-24,NJIT,28,7,21,0.25,5600,663,1681,462,1015,201,666,375,529,321,651,972,294,201,92,311,535,1902,0.394,0.455,0.302,0.709,0.492,0.454
804,2022-23,NJIT,30,7,23,0.233,6100,744,1734,548,1172,196,562,324,488,261,761,1022,336,160,85,334,471,2008,0.429,0.468,0.349,0.664,0.511,0.486
805,2021-22,NJIT,29,11,18,0.379,5875,656,1603,470,1034,186,569,328,498,240,755,995,293,176,106,372,458,1826,0.409,0.455,0.327,0.659,0.496,0.467
806,2020-21,NJIT,19,7,12,0.368,3850,440,1088,321,698,119,390,257,372,168,428,596,181,127,42,212,336,1256,0.404,0.46,0.305,0.691,0.497,0.459
807,2019-20,NJIT,30,9,21,0.3,6000,688,1709,516,1140,172,569,356,523,274,720,994,318,170,89,327,506,1904,0.403,0.453,0.302,0.681,0.486,0.453
808,2023-24,Nicholls State,34,20,14,0.588,7027,849,1909,565,1131,284,778,530,731,325,874,1199,387,229,140,450,636,2512,0.445,0.5,0.365,0.725,0.557,0.519
809,2022-23,Nicholls State,31,16,15,0.516,6200,882,1935,644,1237,238,698,342,530,357,718,1075,431,302,93,420,639,2344,0.456,0.521,0.341,0.645,0.536,0.517
810,2021-22,Nicholls State,33,21,12,0.636,6650,1018,2171,749,1348,269,823,285,456,390,873,1263,448,273,130,405,601,2590,0.469,0.556,0.327,0.625,0.542,0.531
811,2020-21,Nicholls State,25,18,7,0.72,5050,734,1611,540,1006,194,605,298,446,273,679,952,336,228,83,326,462,1960,0.456,0.537,0.321,0.668,0.538,0.516
812,2019-20,Nicholls State,31,21,10,0.677,6250,881,1985,632,1246,249,739,377,504,351,726,1077,408,309,115,419,595,2388,0.444,0.507,0.337,0.748,0.537,0.507
813,2023-24,Niagara,32,16,16,0.5,6475,822,1749,623,1199,199,550,476,633,235,740,975,409,180,70,378,480,2319,0.47,0.52,0.362,0.752,0.566,0.527
814,2022-23,Niagara,31,16,15,0.516,6250,736,1642,540,1072,196,570,348,481,250,694,944,339,165,71,365,499,2016,0.448,0.504,0.344,0.723,0.539,0.508
815,2021-22,Niagara,30,14,16,0.467,6075,737,1678,528,1073,209,605,339,464,229,742,971,367,169,80,328,456,2022,0.439,0.492,0.345,0.731,0.533,0.501
816,2020-21,Niagara,20,9,11,0.45,4000,448,1099,320,690,128,409,269,380,163,468,631,236,117,39,199,340,1293,0.408,0.464,0.313,0.708,0.505,0.466
817,2019-20,Niagara,32,12,20,0.375,6450,766,1785,523,1132,243,653,327,435,190,693,883,381,222,71,338,509,2102,0.429,0.462,0.372,0.752,0.528,0.497
818,2023-24,New Orleans,33,10,23,0.303,6629,846,2023,667,1434,179,589,556,772,377,762,1139,391,254,118,407,629,2427,0.418,0.465,0.304,0.72,0.508,0.462
819,2022-23,New Orleans,32,12,20,0.375,6431,833,1785,637,1266,196,519,478,674,309,723,1032,466,215,70,547,619,2340,0.467,0.503,0.378,0.709,0.556,0.522
820,2021-22,New Orleans,32,18,14,0.563,6450,890,1909,758,1480,132,429,557,762,303,868,1171,416,254,88,457,602,2469,0.466,0.512,0.308,0.731,0.544,0.501
821,2020-21,New Orleans,25,10,15,0.4,5050,703,1476,566,1059,137,417,356,483,245,635,880,391,190,70,421,522,1899,0.476,0.534,0.329,0.737,0.557,0.523
822,2019-20,New Orleans,30,9,21,0.3,6000,800,1731,645,1272,155,459,507,681,285,647,932,446,232,62,418,577,2262,0.462,0.507,0.338,0.744,0.551,0.507
823,2023-24,New Mexico State,32,13,19,0.406,6475,771,1822,565,1196,206,626,418,617,286,793,1079,359,195,98,382,636,2166,0.423,0.472,0.329,0.677,0.512,0.48
824,2022-23,New Mexico State,24,9,15,0.375,4800,631,1426,450,892,181,534,326,479,246,606,852,291,176,55,305,453,1769,0.442,0.504,0.339,0.681,0.535,0.506
825,2021-22,New Mexico State,34,27,7,0.794,6825,869,1913,601,1101,268,812,458,652,369,929,1298,465,170,138,478,539,2464,0.454,0.546,0.33,0.702,0.554,0.524
826,2020-21,New Mexico State,20,12,8,0.6,4000,492,1156,317,603,175,553,263,361,235,487,722,249,100,48,243,359,1422,0.426,0.526,0.316,0.729,0.536,0.501
827,2019-20,New Mexico State,31,25,6,0.806,6225,774,1700,491,902,283,798,383,534,343,748,1091,447,191,55,406,491,2214,0.455,0.544,0.355,0.717,0.567,0.539
828,2023-24,New Mexico,36,26,10,0.722,7200,1067,2343,834,1632,233,711,549,776,462,967,1429,524,312,178,361,632,2916,0.455,0.511,0.328,0.707,0.538,0.505
829,2022-23,New Mexico,34,22,12,0.647,6875,983,2043,791,1498,192,545,591,800,332,928,1260,466,229,134,382,574,2749,0.481,0.528,0.352,0.739,0.567,0.528
830,2021-22,New Mexico,32,13,19,0.406,6450,834,1920,585,1196,249,724,459,612,277,811,1088,376,200,139,375,587,2376,0.434,0.489,0.344,0.75,0.537,0.499
831,2020-21,New Mexico,22,6,16,0.273,4450,538,1303,433,921,105,382,255,426,291,548,839,277,126,87,328,397,1436,0.413,0.47,0.275,0.599,0.477,0.453
832,2019-20,New Mexico,33,19,14,0.576,6600,892,1913,662,1209,230,704,517,718,312,847,1159,494,267,95,475,514,2531,0.466,0.548,0.327,0.72,0.561,0.526
833,2023-24,New Hampshire,31,16,15,0.516,6225,801,1934,526,1086,275,848,421,565,285,875,1160,365,226,64,372,472,2298,0.414,0.484,0.324,0.745,0.522,0.485
834,2022-23,New Hampshire,30,15,15,0.5,6050,696,1749,448,1024,248,725,352,508,307,764,1071,350,161,76,297,452,1992,0.398,0.438,0.342,0.693,0.5,0.469
835,2021-22,New Hampshire,28,15,13,0.536,5600,706,1605,464,944,242,661,271,405,279,725,1004,340,130,80,254,376,1925,0.44,0.492,0.366,0.669,0.536,0.515
836,2020-21,New Hampshire,19,10,9,0.526,3825,452,1124,323,719,129,405,245,358,205,501,706,213,104,55,209,344,1278,0.402,0.449,0.319,0.684,0.494,0.46
837,2019-20,New Hampshire,30,15,15,0.5,6075,750,1838,495,1069,255,769,316,470,343,893,1236,397,144,64,390,548,2071,0.408,0.463,0.332,0.672,0.502,0.477
838,2023-24,Nevada,34,26,8,0.765,6825,881,1860,654,1235,227,625,593,824,302,865,1167,511,214,121,342,599,2582,0.474,0.53,0.363,0.72,0.573,0.535
839,2022-23,Nevada,33,22,11,0.667,6725,799,1794,561,1116,238,678,561,708,245,856,1101,474,197,100,339,592,2397,0.445,0.503,0.351,0.792,0.563,0.512
840,2021-22,Nevada,31,13,18,0.419,6200,802,1786,586,1138,216,648,429,573,257,820,1077,453,198,103,409,545,2249,0.449,0.515,0.333,0.749,0.546,0.51
841,2020-21,Nevada,26,16,10,0.615,5200,646,1445,445,878,201,567,423,560,213,715,928,374,145,77,330,519,1916,0.447,0.507,0.354,0.755,0.56,0.517
842,2019-20,Nevada,31,19,12,0.613,6225,840,1879,531,1073,309,806,400,531,272,916,1188,462,159,109,372,608,2391,0.447,0.495,0.383,0.753,0.561,0.529
843,2023-24,Nebraska,34,23,11,0.676,6875,912,2017,593,1124,319,893,500,658,326,954,1280,521,214,89,377,539,2643,0.452,0.528,0.357,0.76,0.567,0.531
844,2022-23,Nebraska,32,16,16,0.5,6500,819,1790,605,1133,214,657,323,504,264,841,1105,418,177,79,406,452,2175,0.458,0.534,0.326,0.641,0.536,0.517
845,2021-22,Nebraska,32,10,22,0.313,6525,832,1875,608,1174,224,701,457,625,234,825,1059,408,230,87,402,556,2345,0.444,0.518,0.32,0.731,0.54,0.503
846,2020-21,Nebraska,27,7,20,0.259,5425,671,1604,443,920,228,684,319,499,240,739,979,369,193,88,380,473,1889,0.418,0.482,0.333,0.639,0.513,0.489
847,2019-20,Nebraska,32,7,25,0.219,6525,815,2011,562,1215,253,796,352,584,293,841,1134,442,223,79,380,485,2235,0.405,0.463,0.318,0.603,0.488,0.468
848,2023-24,NC State,41,26,15,0.634,8300,1117,2483,832,1656,285,827,582,794,415,1032,1447,536,297,148,392,664,3101,0.45,0.502,0.345,0.733,0.542,0.507
849,2022-23,NC State,34,23,11,0.676,6825,982,2181,701,1371,281,810,398,551,385,859,1244,434,266,152,320,592,2643,0.45,0.511,0.347,0.722,0.541,0.515
850,2021-22,NC State,32,11,21,0.344,6525,824,1997,557,1214,267,783,421,581,377,738,1115,362,225,118,321,527,2336,0.413,0.459,0.341,0.725,0.514,0.479
851,2020-21,NC State,25,14,11,0.56,5025,671,1425,504,961,167,464,311,443,245,569,814,328,202,106,321,400,1820,0.471,0.524,0.36,0.702,0.556,0.529
852,2019-20,NC State,32,20,12,0.625,6425,885,1958,663,1261,222,697,396,558,333,809,1142,434,245,145,383,580,2388,0.452,0.526,0.319,0.71,0.537,0.509
853,2023-24,Navy,31,13,18,0.419,6250,716,1809,535,1206,181,603,447,631,386,718,1104,376,207,63,317,559,2060,0.396,0.444,0.3,0.708,0.488,0.446
854,2022-23,Navy,31,18,13,0.581,6250,808,1781,568,1134,240,647,296,419,310,758,1068,459,215,85,355,494,2152,0.454,0.501,0.371,0.706,0.543,0.521
855,2021-22,Navy,32,21,11,0.656,6450,770,1792,586,1227,184,565,355,542,378,816,1194,392,226,107,412,511,2079,0.43,0.478,0.326,0.655,0.507,0.481
856,2020-21,Navy,18,15,3,0.833,3650,466,1042,355,702,111,340,244,344,204,427,631,222,147,43,223,301,1287,0.447,0.506,0.326,0.709,0.534,0.5
857,2019-20,Navy,30,14,16,0.467,6100,673,1647,479,1003,194,644,368,532,357,725,1082,333,151,51,360,476,1908,0.409,0.478,0.301,0.692,0.502,0.468
858,2023-24,Murray State,32,12,20,0.375,6425,821,1841,612,1190,209,651,381,547,299,749,1048,369,192,88,304,490,2232,0.446,0.514,0.321,0.697,0.531,0.503
859,2022-23,Murray State,32,17,15,0.531,6478,805,1824,608,1231,197,593,447,607,301,810,1111,391,174,83,349,467,2254,0.441,0.494,0.332,0.736,0.534,0.495
860,2021-22,Murray State,34,31,3,0.912,6825,978,2056,706,1281,272,775,462,668,424,904,1328,501,266,108,389,524,2690,0.476,0.551,0.351,0.692,0.567,0.542
861,2020-21,Murray State,26,13,13,0.5,5225,757,1522,545,946,212,576,260,387,239,700,939,435,175,91,347,432,1986,0.497,0.576,0.368,0.672,0.582,0.567
862,2019-20,Murray State,32,23,9,0.719,6450,852,1789,642,1220,210,569,499,704,306,911,1217,461,181,125,440,565,2413,0.476,0.526,0.369,0.709,0.568,0.535
863,2023-24,Mount St. Mary's,32,13,19,0.406,6475,876,1852,659,1237,217,615,358,494,312,813,1125,423,221,125,465,496,2327,0.473,0.533,0.353,0.725,0.558,0.532
864,2022-23,Mount St. Mary's,33,13,20,0.394,6650,771,1818,551,1196,220,622,339,463,308,802,1110,410,182,82,450,540,2101,0.424,0.461,0.354,0.732,0.515,0.485
865,2021-22,Mount St. Mary's,30,14,16,0.467,6050,750,1693,572,1177,178,516,306,445,321,729,1050,398,171,121,388,472,1984,0.443,0.486,0.345,0.688,0.521,0.496
866,2020-21,Mount St. Mary's,23,12,11,0.522,4650,527,1241,375,786,152,455,248,370,241,617,858,266,98,98,297,340,1454,0.425,0.477,0.334,0.67,0.513,0.486
867,2019-20,Mount St. Mary's,32,11,21,0.344,6475,715,1772,506,1094,209,678,414,597,344,776,1120,357,158,105,375,530,2053,0.403,0.463,0.308,0.693,0.499,0.462
868,2023-24,Morgan State,31,11,20,0.355,6250,840,1862,692,1357,148,505,425,561,338,761,1099,388,192,111,451,594,2253,0.451,0.51,0.293,0.758,0.529,0.491
869,2022-23,Morgan State,31,15,16,0.484,6275,863,1911,657,1352,206,559,391,568,362,712,1074,479,303,138,500,647,2323,0.452,0.486,0.369,0.688,0.533,0.505
870,2021-22,Morgan State,28,13,15,0.464,5625,771,1764,599,1215,172,549,386,570,336,694,1030,414,237,96,431,551,2100,0.437,0.493,0.313,0.677,0.516,0.486
871,2020-21,Morgan State,22,14,8,0.636,4400,602,1389,420,859,182,530,369,499,296,577,873,326,173,82,344,455,1755,0.433,0.489,0.343,0.739,0.54,0.499
872,2019-20,Morgan State,31,15,16,0.484,6275,766,1807,608,1244,158,563,492,709,406,816,1222,365,175,132,511,698,2182,0.424,0.489,0.281,0.694,0.509,0.468
873,2023-24,Morehead State,35,26,9,0.743,7000,944,2021,615,1109,329,912,418,592,407,965,1372,526,206,160,413,553,2635,0.467,0.555,0.361,0.706,0.572,0.548
874,2022-23,Morehead State,34,22,12,0.647,6824,823,1889,569,1159,254,730,474,654,325,887,1212,467,193,129,403,532,2374,0.436,0.491,0.348,0.725,0.54,0.503
875,2021-22,Morehead State,34,23,11,0.676,6825,868,1904,585,1118,283,786,360,540,351,895,1246,546,199,196,458,511,2379,0.456,0.523,0.36,0.667,0.551,0.53
876,2020-21,Morehead State,31,23,8,0.742,6250,765,1651,560,1072,205,579,397,584,316,839,1155,397,136,155,477,446,2132,0.463,0.522,0.354,0.68,0.553,0.525
877,2019-20,Morehead State,32,13,19,0.406,6475,826,1902,642,1263,184,639,372,583,342,845,1187,430,190,141,400,512,2208,0.434,0.508,0.288,0.638,0.507,0.483
878,2023-24,Montana State,35,17,18,0.486,7100,941,2012,622,1149,319,863,434,596,237,831,1068,463,289,84,408,647,2635,0.468,0.541,0.37,0.728,0.574,0.547
879,2022-23,Montana State,35,25,10,0.714,7050,879,1876,663,1234,216,642,614,814,291,863,1154,438,229,104,415,641,2588,0.469,0.537,0.336,0.754,0.572,0.526
880,2021-22,Montana State,35,27,8,0.771,7075,923,1952,655,1223,268,729,565,749,305,925,1230,462,183,128,450,639,2679,0.473,0.536,0.368,0.754,0.58,0.541
881,2020-21,Montana State,23,13,10,0.565,4675,586,1298,444,867,142,431,389,515,198,579,777,254,129,52,288,431,1703,0.451,0.512,0.329,0.755,0.552,0.506
882,2019-20,Montana State,31,16,15,0.516,6200,721,1622,546,1090,175,532,449,606,225,851,1076,351,170,72,433,543,2066,0.445,0.501,0.329,0.741,0.541,0.498
883,2023-24,Montana,36,24,12,0.667,7250,1007,2075,730,1301,277,774,477,602,299,928,1227,537,172,107,371,600,2768,0.485,0.561,0.358,0.792,0.586,0.552
884,2022-23,Montana,31,17,14,0.548,6225,762,1650,518,994,244,656,379,481,229,713,942,378,146,74,347,560,2147,0.462,0.521,0.372,0.788,0.571,0.536
885,2021-22,Montana,32,18,14,0.563,6425,794,1752,570,1111,224,641,498,634,200,780,980,420,176,91,328,599,2310,0.453,0.513,0.349,0.785,0.563,0.517
886,2020-21,Montana,28,15,13,0.536,5675,697,1514,543,1089,154,425,433,554,214,713,927,356,137,72,371,552,1981,0.46,0.499,0.362,0.782,0.557,0.511
887,2019-20,Montana,31,18,13,0.581,6275,841,1777,667,1291,174,486,339,469,195,775,970,387,195,101,370,628,2195,0.473,0.517,0.358,0.723,0.549,0.522
888,2023-24,Monmouth,33,18,15,0.545,6605,860,1998,608,1272,252,726,418,585,370,797,1167,432,236,114,345,559,2390,0.43,0.478,0.347,0.715,0.525,0.493
889,2022-23,Monmouth,33,7,26,0.212,6600,746,1856,612,1390,134,466,410,615,365,723,1088,395,278,83,476,635,2036,0.402,0.44,0.288,0.667,0.474,0.438
890,2021-22,Monmouth,34,21,13,0.618,6850,801,1915,585,1263,216,652,515,707,355,886,1241,397,213,113,398,615,2333,0.418,0.463,0.331,0.728,0.518,0.475
891,2020-21,Monmouth,20,12,8,0.6,4075,518,1226,364,802,154,424,331,468,198,551,749,280,166,70,268,415,1521,0.423,0.454,0.363,0.707,0.525,0.485
892,2019-20,Monmouth,31,18,13,0.581,6225,755,1842,528,1162,227,680,472,655,301,757,1058,399,248,86,397,621,2209,0.41,0.454,0.334,0.721,0.513,0.471
893,2023-24,Missouri State,33,17,16,0.515,6700,848,1931,625,1220,223,711,432,608,335,956,1291,399,142,149,397,504,2351,0.439,0.512,0.314,0.711,0.53,0.497
894,2022-23,Missouri State,32,17,15,0.531,6475,772,1776,518,1009,254,767,300,479,363,761,1124,374,199,140,393,497,2098,0.435,0.513,0.331,0.626,0.524,0.506
895,2021-22,Missouri State,34,23,11,0.676,6850,954,1980,671,1224,283,756,437,548,275,924,1199,413,181,113,362,522,2628,0.482,0.548,0.374,0.797,0.587,0.553
896,2020-21,Missouri State,24,17,7,0.708,4800,637,1332,457,817,180,515,308,415,188,699,887,325,112,69,305,369,1762,0.478,0.559,0.35,0.742,0.576,0.546
897,2019-20,Missouri State,33,16,17,0.485,6625,843,1923,613,1273,230,650,414,553,359,867,1226,391,211,86,448,599,2330,0.438,0.482,0.354,0.749,0.533,0.498
898,2023-24,Missouri,32,8,24,0.25,6425,807,1838,574,1108,233,730,462,583,293,699,992,390,245,154,370,642,2309,0.439,0.518,0.319,0.792,0.546,0.502
899,2022-23,Missouri,35,25,10,0.714,7050,988,2092,663,1188,325,904,461,608,310,748,1058,558,357,95,390,631,2762,0.472,0.558,0.36,0.758,0.58,0.55
900,2021-22,Missouri,33,12,21,0.364,6625,790,1854,619,1245,171,609,409,556,361,794,1155,399,215,134,476,587,2160,0.426,0.497,0.281,0.736,0.51,0.472
901,2020-21,Missouri,26,16,10,0.615,5250,668,1497,484,930,184,567,389,555,255,673,928,345,173,92,346,512,1909,0.446,0.52,0.325,0.701,0.542,0.508
902,2019-20,Missouri,31,15,16,0.484,6250,700,1707,495,1017,205,690,476,610,337,754,1091,352,209,99,437,656,2081,0.41,0.487,0.297,0.78,0.521,0.47
903,2023-24,Mississippi Valley State,31,1,30,0.032,6225,613,1611,470,1122,143,489,350,532,298,613,911,271,205,71,495,550,1719,0.381,0.419,0.292,0.658,0.461,0.425
904,2022-23,Mississippi Valley State,32,5,27,0.156,6450,683,1681,521,1217,162,464,425,639,316,711,1027,321,243,65,518,573,1953,0.406,0.428,0.349,0.665,0.492,0.454
905,2021-22,Mississippi Valley State,28,2,26,0.071,5725,665,1722,466,1069,199,653,353,539,269,618,887,324,207,69,375,508,1882,0.386,0.436,0.305,0.655,0.476,0.444
906,2020-21,Mississippi Valley State,24,2,22,0.083,4800,480,1347,266,696,214,651,190,332,168,581,749,264,110,71,430,428,1364,0.356,0.382,0.329,0.572,0.453,0.436
907,2019-20,Mississippi Valley State,30,3,27,0.1,6025,750,2032,504,1195,246,837,302,466,313,736,1049,313,218,87,433,586,2048,0.369,0.422,0.294,0.648,0.454,0.43
908,2023-24,Mississippi State,35,21,14,0.6,7025,917,2027,666,1246,251,781,508,758,436,897,1333,491,284,107,455,580,2593,0.452,0.535,0.321,0.67,0.543,0.514
909,2022-23,Mississippi State,34,21,13,0.618,6900,816,1936,638,1267,178,669,424,655,440,848,1288,482,293,117,434,517,2234,0.421,0.504,0.266,0.647,0.497,0.467
910,2021-22,Mississippi State,34,18,16,0.529,6875,860,1891,703,1359,157,532,519,720,384,850,1234,455,269,113,447,534,2396,0.455,0.517,0.295,0.721,0.536,0.496
911,2020-21,Mississippi State,33,18,15,0.545,6700,847,1866,668,1344,179,522,414,629,400,887,1287,428,207,149,498,512,2287,0.454,0.497,0.343,0.658,0.528,0.502
912,2019-20,Mississippi State,31,20,11,0.645,6200,802,1713,641,1234,161,479,510,676,371,789,1160,415,174,158,431,542,2275,0.468,0.519,0.336,0.754,0.559,0.515
913,2023-24,Minnesota,34,19,15,0.559,6825,910,1930,642,1176,268,754,462,670,343,844,1187,588,214,150,408,547,2550,0.472,0.546,0.355,0.69,0.567,0.541
914,2022-23,Minnesota,31,9,22,0.29,6250,720,1664,528,1073,192,591,317,512,262,755,1017,454,143,124,401,482,1949,0.433,0.492,0.325,0.619,0.511,0.49
915,2021-22,Minnesota,30,13,17,0.433,6050,744,1699,510,1063,234,636,288,401,180,740,920,379,160,83,276,422,2010,0.438,0.48,0.368,0.718,0.532,0.507
916,2020-21,Minnesota,29,14,15,0.483,5875,704,1794,497,1064,207,730,488,659,340,727,1067,399,183,134,324,538,2103,0.392,0.467,0.284,0.741,0.499,0.45
917,2019-20,Minnesota,31,15,16,0.484,6250,796,1871,539,1109,257,762,356,515,360,857,1217,466,147,144,351,515,2205,0.425,0.486,0.337,0.691,0.521,0.494
918,2023-24,Milwaukee,35,20,15,0.571,7125,980,2198,703,1337,277,861,545,750,473,891,1364,498,208,155,439,635,2782,0.446,0.526,0.322,0.727,0.545,0.509
919,2022-23,Milwaukee,34,22,12,0.647,6924,944,2062,677,1288,267,774,504,681,405,925,1330,472,236,186,515,610,2659,0.458,0.526,0.345,0.74,0.557,0.523
920,2021-22,Milwaukee,32,10,22,0.313,6400,762,1805,563,1177,199,628,350,488,286,863,1149,366,157,119,423,541,2073,0.422,0.478,0.317,0.717,0.509,0.477
921,2020-21,Milwaukee,22,10,12,0.455,4500,588,1348,429,864,159,484,327,447,197,573,770,285,134,47,244,405,1662,0.436,0.497,0.329,0.732,0.533,0.495
922,2019-20,Milwaukee,31,12,19,0.387,6325,788,1908,547,1154,241,754,399,563,353,762,1115,387,182,95,417,668,2216,0.413,0.474,0.32,0.709,0.509,0.476
923,2023-24,Middle Tennessee,33,14,19,0.424,6725,741,1843,500,1069,241,774,444,631,344,803,1147,329,175,138,462,516,2167,0.402,0.468,0.311,0.704,0.506,0.467
924,2022-23,Middle Tennessee,33,19,14,0.576,6650,857,1892,629,1218,228,674,371,543,366,743,1109,356,249,159,439,579,2313,0.453,0.516,0.338,0.683,0.538,0.513
925,2021-22,Middle Tennessee,37,26,11,0.703,7550,963,2140,661,1226,302,914,543,718,381,925,1306,460,295,156,477,680,2771,0.45,0.539,0.33,0.756,0.558,0.521
926,2020-21,Middle Tennessee,23,5,18,0.217,4600,511,1323,340,795,171,528,233,341,223,545,768,229,164,52,345,372,1426,0.386,0.428,0.324,0.683,0.48,0.451
927,2019-20,Middle Tennessee,31,8,23,0.258,6250,776,1850,521,1087,255,763,386,576,332,751,1083,406,211,91,435,620,2193,0.419,0.479,0.334,0.67,0.516,0.488
928,2023-24,Michigan State,35,20,15,0.571,7025,949,2058,722,1432,227,626,426,602,353,862,1215,558,248,132,350,581,2551,0.461,0.504,0.363,0.708,0.544,0.516
929,2022-23,Michigan State,34,21,13,0.618,6900,879,1944,627,1302,252,642,401,528,307,906,1213,497,160,102,370,557,2411,0.452,0.482,0.393,0.759,0.549,0.517
930,2021-22,Michigan State,36,23,13,0.639,7200,939,2059,677,1365,262,694,461,615,363,966,1329,565,205,181,459,609,2601,0.456,0.496,0.378,0.75,0.553,0.52
931,2020-21,Michigan State,28,15,13,0.536,5625,697,1635,519,1080,178,555,372,512,304,744,1048,444,125,132,364,554,1944,0.426,0.481,0.321,0.727,0.518,0.481
932,2019-20,Michigan State,31,22,9,0.71,6200,845,1833,606,1146,239,687,424,565,344,914,1258,549,159,156,389,523,2353,0.461,0.529,0.348,0.75,0.56,0.526
933,2023-24,Michigan,32,8,24,0.25,6475,829,1869,574,1159,255,710,421,599,340,794,1134,400,133,114,414,549,2334,0.444,0.495,0.359,0.703,0.542,0.512
934,2022-23,Michigan,34,18,16,0.529,6950,898,1994,637,1250,261,744,437,615,300,948,1248,414,158,157,356,527,2494,0.45,0.51,0.351,0.711,0.545,0.516
935,2021-22,Michigan,34,19,15,0.559,6800,914,1957,701,1329,213,628,429,575,337,878,1215,481,160,112,396,516,2470,0.467,0.527,0.339,0.746,0.554,0.521
936,2020-21,Michigan,28,23,5,0.821,5625,771,1598,565,1057,206,541,373,485,250,799,1049,443,120,117,315,412,2123,0.482,0.535,0.381,0.769,0.581,0.547
937,2019-20,Michigan,31,19,12,0.613,6275,861,1864,614,1135,247,729,357,498,267,852,1119,454,169,140,332,470,2326,0.462,0.541,0.339,0.717,0.554,0.528
938,2023-24,Miami (OH),32,15,17,0.469,6424,798,1802,539,1085,259,717,404,572,257,806,1063,462,202,99,375,552,2259,0.443,0.497,0.361,0.706,0.545,0.515
939,2022-23,Miami (OH),32,12,20,0.375,6425,830,1817,580,1081,250,736,447,568,287,735,1022,440,195,94,436,583,2357,0.457,0.537,0.34,0.787,0.565,0.526
940,2021-22,Miami (OH),32,14,18,0.438,6450,870,1980,578,1136,292,844,376,478,315,792,1107,440,177,101,332,512,2408,0.439,0.509,0.346,0.787,0.546,0.513
941,2020-21,Miami (OH),23,12,11,0.522,4625,598,1369,401,829,197,540,270,348,226,572,798,278,102,59,248,388,1663,0.437,0.484,0.365,0.776,0.542,0.509
942,2019-20,Miami (OH),32,13,19,0.406,6400,814,1920,546,1129,268,791,373,513,304,826,1130,383,164,75,363,584,2269,0.424,0.484,0.339,0.727,0.524,0.494
943,2023-24,Miami (FL),32,15,17,0.469,6425,889,1960,603,1168,286,792,360,483,324,850,1174,454,229,100,386,419,2424,0.454,0.516,0.361,0.745,0.554,0.527
944,2022-23,Miami (FL),37,29,8,0.784,7425,1058,2205,780,1450,278,755,531,677,384,901,1285,535,270,115,411,527,2925,0.48,0.538,0.368,0.784,0.579,0.543
945,2021-22,Miami (FL),37,26,11,0.703,7425,1011,2136,754,1377,257,759,457,616,269,863,1132,523,328,118,352,550,2736,0.473,0.548,0.339,0.742,0.563,0.533
946,2020-21,Miami (FL),27,10,17,0.37,5425,647,1524,497,1016,150,508,350,500,257,687,944,305,179,104,340,333,1794,0.425,0.489,0.295,0.7,0.509,0.474
947,2019-20,Miami (FL),31,15,16,0.484,6350,796,1855,577,1165,219,690,396,522,292,777,1069,310,183,119,374,447,2207,0.429,0.495,0.317,0.759,0.525,0.488
948,2023-24,Merrimack,33,21,12,0.636,6650,795,1814,554,1035,241,779,452,620,260,774,1034,409,325,121,436,532,2283,0.438,0.535,0.309,0.729,0.541,0.505
949,2022-23,Merrimack,34,18,16,0.529,6802,732,1745,481,977,251,768,413,599,229,745,974,429,380,139,479,482,2128,0.419,0.492,0.327,0.689,0.524,0.491
950,2021-22,Merrimack,30,14,16,0.467,6050,673,1600,459,953,214,647,283,419,224,631,855,346,271,120,353,478,1843,0.421,0.482,0.331,0.675,0.512,0.488
951,2020-21,Merrimack,18,9,9,0.5,3625,434,967,308,569,126,398,199,300,124,432,556,216,144,68,245,305,1193,0.449,0.541,0.317,0.663,0.538,0.514
952,2019-20,Merrimack,31,20,11,0.645,6275,705,1682,458,954,247,728,291,427,243,647,890,397,308,92,368,536,1948,0.419,0.48,0.339,0.681,0.517,0.493
953,2023-24,Mercer,33,16,17,0.485,6600,880,1961,670,1353,210,608,378,565,368,764,1132,434,229,113,367,631,2348,0.449,0.495,0.345,0.669,0.527,0.502
954,2022-23,Mercer,33,14,19,0.424,6675,851,1885,655,1299,196,586,370,536,342,802,1144,422,185,71,385,592,2268,0.451,0.504,0.334,0.69,0.53,0.503
955,2021-22,Mercer,33,16,17,0.485,6650,828,1811,560,1047,268,764,401,521,260,827,1087,473,203,98,408,502,2325,0.457,0.535,0.351,0.77,0.565,0.531
956,2020-21,Mercer,29,18,11,0.621,5900,832,1738,582,1065,250,673,311,433,252,801,1053,479,200,86,373,445,2225,0.479,0.546,0.371,0.718,0.572,0.551
957,2019-20,Mercer,32,17,15,0.531,6400,847,1885,601,1199,246,686,354,490,332,840,1172,461,211,83,463,601,2294,0.449,0.501,0.359,0.722,0.542,0.515
958,2023-24,Memphis,32,22,10,0.688,6450,897,1952,631,1193,266,759,514,709,383,802,1185,438,274,145,419,551,2576,0.46,0.529,0.35,0.725,0.563,0.528
959,2022-23,Memphis,35,26,9,0.743,7075,1004,2096,789,1487,215,609,555,743,364,892,1256,546,301,158,467,637,2778,0.479,0.531,0.353,0.747,0.567,0.53
960,2021-22,Memphis,33,22,11,0.667,6600,889,1895,684,1318,205,577,497,716,413,867,1280,522,277,180,527,621,2480,0.469,0.519,0.355,0.694,0.555,0.523
961,2020-21,Memphis,28,20,8,0.714,5600,737,1661,519,1061,218,600,335,543,339,782,1121,447,248,136,437,531,2027,0.444,0.489,0.363,0.617,0.528,0.509
962,2019-20,Memphis,31,21,10,0.677,6250,775,1763,571,1143,204,620,478,704,324,916,1240,438,242,184,510,607,2232,0.44,0.5,0.329,0.679,0.532,0.497
963,2023-24,McNeese State,34,30,4,0.882,6800,973,1997,716,1326,257,671,516,745,382,844,1226,506,350,115,329,588,2719,0.487,0.54,0.383,0.693,0.578,0.552
964,2022-23,McNeese State,34,11,23,0.324,6875,858,1991,600,1198,258,793,378,571,422,776,1198,385,246,61,499,655,2352,0.431,0.501,0.325,0.662,0.52,0.496
965,2021-22,McNeese State,33,11,22,0.333,6750,933,2071,720,1390,213,681,500,759,458,878,1336,418,257,116,536,662,2579,0.451,0.518,0.313,0.659,0.53,0.502
966,2020-21,McNeese State,24,10,14,0.417,4800,718,1456,514,930,204,526,287,417,255,641,896,443,172,49,359,410,1927,0.493,0.553,0.388,0.688,0.583,0.563
967,2019-20,McNeese State,32,15,17,0.469,6450,911,1833,642,1158,269,675,449,620,321,832,1153,522,211,124,509,534,2540,0.497,0.554,0.399,0.724,0.597,0.57
968,2023-24,Massachusetts,31,20,11,0.645,6225,858,1904,649,1236,209,668,476,681,416,772,1188,483,236,93,345,579,2401,0.451,0.525,0.313,0.699,0.539,0.506
969,2022-23,Massachusetts,31,15,16,0.484,6200,775,1868,593,1313,182,555,431,602,404,783,1187,423,211,119,443,541,2163,0.415,0.452,0.328,0.716,0.502,0.464
970,2021-22,Massachusetts,32,15,17,0.469,6475,823,1901,519,1082,304,819,472,623,335,744,1079,437,207,83,371,546,2422,0.433,0.48,0.371,0.758,0.551,0.513
971,2020-21,Massachusetts,15,8,7,0.533,3075,394,920,262,515,132,405,231,315,136,381,517,224,110,61,181,261,1151,0.428,0.509,0.326,0.733,0.538,0.5
972,2019-20,Massachusetts,31,14,17,0.452,6250,758,1780,523,1065,235,715,373,532,278,728,1006,412,211,99,407,566,2124,0.426,0.491,0.329,0.701,0.522,0.492
973,2023-24,Maryland Eastern Shore,29,9,20,0.31,5875,668,1664,500,1094,168,570,386,540,315,699,1014,312,203,81,399,508,1890,0.401,0.457,0.295,0.715,0.492,0.452
974,2022-23,Maryland Eastern Shore,31,18,13,0.581,6225,776,1812,547,1092,229,720,381,530,305,683,988,417,345,59,454,515,2162,0.428,0.501,0.318,0.719,0.524,0.491
975,2021-22,Maryland Eastern Shore,27,11,16,0.407,5450,631,1562,422,897,209,665,307,477,292,643,935,336,272,61,416,453,1778,0.404,0.47,0.314,0.644,0.497,0.471
976,2019-20,Maryland Eastern Shore,32,5,27,0.156,6450,676,1869,489,1124,187,745,302,478,333,762,1095,354,246,102,475,579,1841,0.362,0.435,0.251,0.632,0.439,0.412
977,2023-24,Maryland,33,16,17,0.485,6675,766,1854,565,1158,201,696,545,757,380,799,1179,360,217,149,387,576,2278,0.413,0.488,0.289,0.72,0.515,0.467
978,2022-23,Maryland,35,22,13,0.629,7025,862,1925,629,1215,233,710,483,660,342,833,1175,398,191,131,373,560,2440,0.448,0.518,0.328,0.732,0.545,0.508
979,2021-22,Maryland,32,15,17,0.469,6450,790,1824,569,1146,221,678,469,618,303,823,1126,372,204,102,366,485,2270,0.433,0.497,0.326,0.759,0.536,0.494
980,2020-21,Maryland,31,17,14,0.548,6200,753,1636,500,928,253,708,376,538,195,818,1013,415,155,103,343,455,2135,0.46,0.539,0.357,0.699,0.564,0.538
981,2019-20,Maryland,31,24,7,0.774,6200,744,1774,506,1009,238,765,500,669,348,836,1184,409,142,134,350,463,2226,0.419,0.501,0.311,0.747,0.532,0.486
982,2023-24,Marshall,33,13,20,0.394,6600,864,2117,594,1247,270,870,437,615,406,897,1303,492,230,144,393,530,2435,0.408,0.476,0.31,0.711,0.505,0.472
983,2022-23,Marshall,32,24,8,0.75,6475,986,2120,722,1339,264,781,380,548,395,852,1247,561,288,169,372,526,2616,0.465,0.539,0.338,0.693,0.55,0.527
984,2021-22,Marshall,33,12,21,0.364,6600,919,2107,669,1277,250,830,354,502,356,870,1226,471,223,160,433,511,2442,0.436,0.524,0.301,0.705,0.521,0.495
985,2020-21,Marshall,22,15,7,0.682,4425,656,1382,452,815,204,567,242,334,183,595,778,349,172,114,263,333,1758,0.475,0.555,0.36,0.725,0.571,0.548
986,2019-20,Marshall,32,17,15,0.531,6425,897,2028,652,1245,245,783,390,588,347,893,1240,454,260,190,471,602,2429,0.442,0.524,0.313,0.663,0.526,0.503
987,2023-24,Marquette,37,27,10,0.73,7425,1078,2256,751,1328,327,928,405,576,322,890,1212,587,317,131,369,556,2888,0.478,0.566,0.352,0.703,0.571,0.55
988,2022-23,Marquette,36,29,7,0.806,7300,1056,2174,734,1262,322,912,422,588,317,829,1146,624,330,108,386,582,2856,0.486,0.582,0.353,0.718,0.582,0.56
989,2021-22,Marquette,32,19,13,0.594,6450,861,1915,586,1115,275,800,372,502,251,862,1113,511,249,165,396,556,2369,0.45,0.526,0.344,0.741,0.55,0.521
990,2020-21,Marquette,27,13,14,0.481,5425,661,1484,482,929,179,555,382,520,258,721,979,333,137,100,388,465,1883,0.445,0.519,0.323,0.735,0.544,0.506
991,2019-20,Marquette,30,18,12,0.6,6100,759,1764,458,977,301,787,514,692,317,878,1195,406,154,127,410,572,2333,0.43,0.469,0.382,0.743,0.557,0.516
992,2023-24,Marist,31,18,13,0.581,6200,726,1638,514,1042,212,596,340,488,222,774,996,381,212,87,378,503,2004,0.443,0.493,0.356,0.697,0.536,0.508
993,2022-23,Marist,33,13,20,0.394,6625,745,1819,492,1048,253,771,367,526,294,837,1131,357,195,124,392,509,2110,0.41,0.469,0.328,0.698,0.51,0.479
994,2021-22,Marist,30,14,16,0.467,6075,763,1737,538,1083,225,654,312,434,274,780,1054,269,175,101,371,467,2063,0.439,0.497,0.344,0.719,0.531,0.504
995,2020-21,Marist,21,12,9,0.571,4250,475,1113,333,655,142,458,240,351,158,578,736,229,114,84,303,370,1332,0.427,0.508,0.31,0.684,0.52,0.491
996,2019-20,Marist,30,7,23,0.233,6125,639,1634,416,980,223,654,315,486,277,733,1010,315,204,88,420,553,1816,0.391,0.424,0.341,0.648,0.487,0.459
997,2023-24,Manhattan,30,7,23,0.233,6075,740,1792,521,1097,219,695,286,396,275,714,989,432,226,88,402,417,1985,0.413,0.475,0.315,0.722,0.501,0.474
998,2022-23,Manhattan,30,12,18,0.4,6123,733,1682,528,1066,205,616,343,520,274,678,952,370,227,105,406,492,2016,0.436,0.495,0.333,0.66,0.523,0.497
999,2021-22,Manhattan,30,15,15,0.5,6075,730,1659,561,1109,169,550,497,676,304,695,999,346,215,100,434,540,2126,0.44,0.506,0.307,0.735,0.537,0.491
1000,2020-21,Manhattan,20,7,13,0.35,4125,439,1165,324,730,115,435,275,413,253,471,724,237,154,74,288,453,1268,0.377,0.444,0.264,0.666,0.466,0.426
1001,2019-20,Manhattan,31,13,18,0.419,6250,676,1708,466,1029,210,679,362,583,343,727,1070,392,218,123,432,634,1924,0.396,0.453,0.309,0.621,0.485,0.457
1002,2023-24,Maine,32,15,17,0.469,6450,801,1831,628,1244,173,587,389,541,255,789,1044,397,269,105,365,522,2164,0.437,0.505,0.295,0.719,0.518,0.485
1003,2022-23,Maine,30,13,17,0.433,6075,784,1711,586,1116,198,595,288,396,232,692,924,415,284,62,371,446,2054,0.458,0.525,0.333,0.727,0.541,0.516
1004,2021-22,Maine,29,6,23,0.207,5800,685,1654,489,1017,196,637,245,345,256,655,911,386,208,80,366,505,1811,0.414,0.481,0.308,0.71,0.498,0.473
1005,2020-21,Maine,9,2,7,0.222,1800,172,452,108,249,64,203,70,123,69,212,281,108,51,40,147,161,478,0.381,0.434,0.315,0.569,0.468,0.451
1006,2019-20,Maine,31,9,22,0.29,6250,689,1693,483,961,206,732,320,450,300,762,1062,428,215,107,466,547,1904,0.407,0.503,0.281,0.711,0.499,0.468
1007,2023-24,Loyola Marymount,31,12,19,0.387,6200,802,1791,541,1081,261,710,379,519,307,775,1082,369,114,81,333,504,2244,0.448,0.5,0.368,0.73,0.551,0.521
1008,2022-23,Loyola Marymount,31,19,12,0.613,6275,832,1831,543,1039,289,792,382,569,328,791,1119,366,169,86,397,602,2335,0.454,0.523,0.365,0.671,0.556,0.533
1009,2021-22,Loyola Marymount,29,11,18,0.379,5850,718,1580,508,971,210,609,364,506,229,632,861,323,158,50,385,515,2010,0.454,0.523,0.345,0.719,0.552,0.521
1010,2020-21,Loyola Marymount,22,13,9,0.591,4425,525,1147,390,747,135,400,344,474,215,557,772,280,103,58,351,417,1529,0.458,0.522,0.338,0.726,0.557,0.517
1011,2019-20,Loyola Marymount,32,11,21,0.344,6425,751,1616,578,1056,173,560,382,561,252,708,960,372,187,67,449,606,2057,0.465,0.547,0.309,0.681,0.546,0.518
1012,2023-24,Loyola Chicago,33,23,10,0.697,6650,855,1900,581,1125,274,775,428,629,317,896,1213,547,233,166,423,643,2412,0.45,0.516,0.354,0.68,0.548,0.522
1013,2022-23,Loyola Chicago,31,10,21,0.323,6275,757,1638,537,980,220,658,355,509,233,727,960,428,175,94,464,601,2089,0.462,0.548,0.334,0.697,0.556,0.529
1014,2021-22,Loyola Chicago,33,25,8,0.758,6700,855,1795,562,1022,293,773,400,562,257,862,1119,492,229,80,404,568,2403,0.476,0.55,0.379,0.712,0.583,0.558
1015,2020-21,Loyola Chicago,31,26,5,0.839,6250,804,1614,583,1008,221,606,373,519,230,778,1008,490,215,75,364,444,2202,0.498,0.578,0.365,0.719,0.592,0.567
1016,2019-20,Loyola Chicago,32,21,11,0.656,6475,803,1616,618,1112,185,504,407,626,200,763,963,457,252,51,411,443,2198,0.497,0.556,0.367,0.65,0.574,0.554
1017,2023-24,Loyola (MD),32,7,25,0.219,6475,737,1767,507,1082,230,685,345,536,328,769,1097,410,189,69,436,518,2049,0.417,0.469,0.336,0.644,0.507,0.482
1018,2022-23,Loyola (MD),33,13,20,0.394,6625,822,1821,572,1120,250,701,328,509,301,734,1035,459,247,78,446,517,2222,0.451,0.511,0.357,0.644,0.539,0.52
1019,2021-22,Loyola (MD),30,14,16,0.467,6050,747,1689,540,1040,207,649,283,414,246,717,963,448,235,80,391,460,1984,0.442,0.519,0.319,0.684,0.526,0.504
1020,2020-21,Loyola (MD),17,6,11,0.353,3550,461,992,369,691,92,301,212,351,191,448,639,221,116,54,245,308,1226,0.465,0.534,0.306,0.604,0.529,0.511
1021,2019-20,Loyola (MD),32,15,17,0.469,6450,830,1784,618,1121,212,663,476,747,281,823,1104,495,216,93,438,564,2348,0.465,0.551,0.32,0.637,0.549,0.525
1022,2023-24,Louisville,32,8,24,0.25,6425,799,1833,624,1262,175,571,531,712,318,782,1100,356,174,83,410,544,2304,0.436,0.494,0.306,0.746,0.531,0.484
1023,2022-23,Louisville,32,4,28,0.125,6400,716,1700,516,1092,200,608,414,559,294,737,1031,299,145,90,478,527,2046,0.421,0.473,0.329,0.741,0.52,0.48
1024,2021-22,Louisville,32,13,19,0.406,6450,795,1882,549,1087,246,795,318,472,319,848,1167,382,196,77,391,549,2154,0.422,0.505,0.309,0.674,0.511,0.488
1025,2020-21,Louisville,20,13,7,0.65,4025,494,1146,387,799,107,347,264,368,225,539,764,221,96,37,229,338,1359,0.431,0.484,0.308,0.717,0.514,0.478
1026,2019-20,Louisville,31,24,7,0.774,6250,810,1787,555,1108,255,679,421,576,335,862,1197,433,157,83,376,524,2296,0.453,0.501,0.376,0.731,0.557,0.525
1027,2023-24,Louisiana–Monroe,30,11,19,0.367,6025,751,1788,599,1275,152,513,442,665,396,737,1133,381,219,66,374,539,2096,0.42,0.47,0.296,0.665,0.498,0.463
1028,2022-23,Louisiana–Monroe,32,11,21,0.344,6475,759,1860,517,1170,242,690,397,557,345,779,1124,403,220,114,405,484,2157,0.408,0.442,0.351,0.713,0.508,0.473
1029,2021-22,Louisiana–Monroe,31,13,18,0.419,6275,839,1847,620,1199,219,648,349,482,276,728,1004,466,223,85,395,521,2246,0.454,0.517,0.338,0.724,0.541,0.514
1030,2020-21,Louisiana–Monroe,26,7,19,0.269,5225,609,1464,415,893,194,571,258,367,205,586,791,355,193,74,338,433,1670,0.416,0.465,0.34,0.703,0.51,0.482
1031,2019-20,Louisiana–Monroe,29,9,20,0.31,5825,653,1556,473,1017,180,539,345,506,260,719,979,336,130,96,394,488,1831,0.42,0.465,0.334,0.682,0.51,0.478
1032,2023-24,Louisiana Tech,32,22,10,0.688,6450,823,1802,594,1169,229,633,517,738,376,868,1244,404,240,161,398,500,2392,0.457,0.508,0.362,0.701,0.556,0.52
1033,2022-23,Louisiana Tech,33,15,18,0.455,6750,854,1930,573,1116,281,814,394,546,359,786,1145,408,260,87,451,570,2383,0.442,0.513,0.345,0.722,0.544,0.515
1034,2021-22,Louisiana Tech,34,24,10,0.706,6800,911,2001,630,1175,281,826,455,628,315,915,1230,465,221,73,392,497,2558,0.455,0.536,0.34,0.725,0.556,0.525
1035,2020-21,Louisiana Tech,32,24,8,0.75,6400,832,1870,592,1172,240,698,435,639,323,901,1224,418,217,93,411,497,2339,0.445,0.505,0.344,0.681,0.538,0.509
1036,2019-20,Louisiana Tech,30,22,8,0.733,6050,821,1763,570,1059,251,704,342,512,314,796,1110,401,222,75,373,508,2235,0.466,0.538,0.357,0.668,0.557,0.537
1037,2023-24,Louisiana State,33,17,16,0.515,6625,868,1907,612,1190,256,717,528,730,345,832,1177,388,264,125,434,574,2520,0.455,0.514,0.357,0.723,0.559,0.522
1038,2022-23,Louisiana State,33,14,19,0.424,6600,768,1875,529,1145,239,730,456,632,376,780,1156,406,223,88,405,560,2231,0.41,0.462,0.327,0.722,0.513,0.473
1039,2021-22,Louisiana State,34,22,12,0.647,6850,879,2005,659,1308,220,697,489,669,411,846,1257,431,373,145,499,651,2467,0.438,0.504,0.316,0.731,0.531,0.493
1040,2020-21,Louisiana State,29,19,10,0.655,5825,836,1823,602,1149,234,674,465,619,330,783,1113,351,225,85,329,505,2371,0.459,0.524,0.347,0.751,0.56,0.523
1041,2019-20,Louisiana State,31,21,10,0.677,6250,886,1880,675,1235,211,645,512,666,375,855,1230,398,195,121,390,495,2495,0.471,0.547,0.327,0.769,0.568,0.527
1042,2023-24,Louisiana,33,19,14,0.576,6600,919,2025,668,1282,251,743,415,569,371,762,1133,409,284,124,388,592,2504,0.454,0.521,0.338,0.729,0.545,0.516
1043,2022-23,Louisiana,34,26,8,0.765,6826,950,1972,711,1337,239,635,491,720,377,864,1241,489,244,102,415,577,2630,0.482,0.532,0.376,0.682,0.568,0.542
1044,2021-22,Louisiana,31,16,15,0.516,6250,766,1791,538,1132,228,659,443,630,369,834,1203,384,211,135,476,555,2203,0.428,0.475,0.346,0.703,0.527,0.491
1045,2020-21,Louisiana,26,17,9,0.654,5250,713,1607,528,1075,185,532,323,463,317,710,1027,332,145,122,388,457,1934,0.444,0.491,0.348,0.698,0.529,0.501
1046,2019-20,Louisiana,33,14,19,0.424,6625,825,1972,566,1166,259,806,507,682,349,812,1161,378,198,103,464,584,2416,0.418,0.485,0.321,0.743,0.526,0.484
1047,2023-24,Longwood,35,21,14,0.6,7100,931,2053,730,1463,201,590,552,804,470,873,1343,446,244,88,444,639,2615,0.453,0.499,0.341,0.687,0.537,0.502
1048,2022-23,Longwood,32,20,12,0.625,6400,831,1837,590,1152,241,685,438,607,357,754,1111,398,206,70,380,531,2341,0.452,0.512,0.352,0.722,0.551,0.518
1049,2021-22,Longwood,33,26,7,0.788,6650,873,1932,604,1220,269,712,484,667,392,825,1217,464,257,79,399,507,2499,0.452,0.495,0.378,0.726,0.556,0.521
1050,2020-21,Longwood,29,12,17,0.414,5800,685,1579,478,979,207,600,343,498,273,681,954,309,177,52,381,499,1920,0.434,0.488,0.345,0.689,0.529,0.499
1051,2019-20,Longwood,32,14,18,0.438,6500,720,1781,427,924,293,857,415,592,272,825,1097,349,215,67,437,595,2148,0.404,0.462,0.342,0.701,0.521,0.487
1052,2023-24,Long Beach State,36,21,15,0.583,7250,993,2239,799,1602,194,637,606,855,450,949,1399,550,285,151,455,620,2786,0.444,0.499,0.305,0.709,0.527,0.487
1053,2022-23,Long Beach State,33,17,16,0.515,6775,949,2086,803,1592,146,494,480,708,429,912,1341,494,245,108,466,563,2524,0.455,0.504,0.296,0.678,0.521,0.49
1054,2021-22,Long Beach State,33,20,13,0.606,6675,841,1926,628,1311,213,615,542,743,325,841,1166,411,232,102,437,542,2437,0.437,0.479,0.346,0.729,0.535,0.492
1055,2020-21,Long Beach State,18,6,12,0.333,3700,466,1047,339,693,127,354,269,395,147,483,630,210,112,52,288,349,1328,0.445,0.489,0.359,0.681,0.538,0.506
1056,2019-20,Long Beach State,32,11,21,0.344,6450,772,1789,585,1256,187,533,426,609,281,811,1092,354,189,132,515,565,2157,0.432,0.466,0.351,0.7,0.519,0.484
1057,2023-24,LIU,29,7,22,0.241,5850,706,1691,549,1185,157,506,360,532,272,742,1014,363,187,88,422,557,1929,0.418,0.463,0.31,0.677,0.496,0.464
1058,2022-23,LIU,29,3,26,0.103,5800,720,1683,578,1263,142,420,353,535,275,730,1005,420,192,99,475,511,1935,0.428,0.458,0.338,0.66,0.499,0.47
1059,2021-22,LIU,30,16,14,0.533,6050,812,1897,574,1139,238,758,383,563,353,829,1182,508,231,147,408,508,2245,0.428,0.504,0.314,0.68,0.519,0.491
1060,2020-21,LIU,18,9,9,0.5,3600,479,1155,345,688,134,467,240,360,240,465,705,293,152,69,259,315,1332,0.415,0.501,0.287,0.667,0.502,0.473
1061,2019-20,LIU,33,15,18,0.455,6700,867,1966,555,1060,312,906,458,641,255,870,1125,471,223,111,461,562,2504,0.441,0.524,0.344,0.715,0.551,0.52
1062,2023-24,Little Rock,34,21,13,0.618,6850,957,2024,740,1395,217,629,497,664,369,875,1244,502,203,160,417,596,2628,0.473,0.53,0.345,0.748,0.562,0.526
1063,2022-23,Little Rock,31,10,21,0.323,6250,845,1907,660,1340,185,567,462,632,339,768,1107,460,209,72,418,609,2337,0.443,0.493,0.326,0.731,0.529,0.492
1064,2021-22,Little Rock,28,9,19,0.321,5700,651,1544,454,959,197,585,369,502,233,648,881,364,194,60,387,468,1868,0.422,0.473,0.337,0.735,0.524,0.485
1065,2020-21,Little Rock,26,11,15,0.423,5250,638,1401,491,929,147,472,363,517,261,637,898,354,165,86,392,419,1786,0.455,0.529,0.311,0.702,0.542,0.508
1066,2019-20,Little Rock,31,21,10,0.677,6200,777,1653,589,1110,188,543,528,744,307,789,1096,462,214,113,479,577,2270,0.47,0.531,0.346,0.71,0.566,0.527
1067,2023-24,Lipscomb,32,20,12,0.625,6400,960,1946,663,1165,297,781,409,533,244,820,1064,465,196,110,321,414,2626,0.493,0.569,0.38,0.767,0.597,0.57
1068,2022-23,Lipscomb,33,20,13,0.606,6700,943,1983,677,1235,266,748,369,496,289,909,1198,466,177,92,399,460,2521,0.476,0.548,0.356,0.744,0.568,0.543
1069,2021-22,Lipscomb,33,14,19,0.424,6600,850,1860,583,1084,267,776,475,652,252,934,1186,502,146,89,425,444,2442,0.457,0.538,0.344,0.729,0.563,0.529
1070,2020-21,Lipscomb,27,15,12,0.556,5425,687,1493,487,924,200,569,348,503,208,710,918,364,167,53,326,376,1922,0.46,0.527,0.351,0.692,0.555,0.527
1071,2019-20,Lipscomb,32,16,16,0.5,6425,834,1849,616,1209,218,640,369,533,299,830,1129,423,172,83,410,488,2255,0.451,0.51,0.341,0.692,0.536,0.51
1072,2023-24,Lindenwood,31,9,22,0.29,6225,696,1726,547,1199,149,527,478,653,272,711,983,249,191,77,373,541,2019,0.403,0.456,0.283,0.732,0.496,0.446
1073,2022-23,Lindenwood,32,11,21,0.344,6525,804,1873,565,1209,239,664,379,520,288,811,1099,376,203,105,424,514,2226,0.429,0.467,0.36,0.729,0.525,0.493
1074,2023-24,Liberty,32,18,14,0.563,6450,863,1848,539,968,324,880,312,472,279,808,1087,508,167,74,334,480,2362,0.467,0.557,0.368,0.661,0.57,0.555
1075,2022-23,Liberty,36,27,9,0.75,7200,963,2032,587,1025,376,1007,387,532,296,923,1219,580,226,82,373,540,2689,0.474,0.573,0.373,0.727,0.588,0.566
1076,2021-22,Liberty,33,22,11,0.667,6650,851,1801,510,909,341,892,378,500,234,897,1131,486,178,63,383,495,2421,0.473,0.561,0.382,0.756,0.594,0.567
1077,2020-21,Liberty,29,23,6,0.793,5800,782,1605,485,844,297,761,296,381,202,769,971,458,135,71,289,429,2157,0.487,0.575,0.39,0.777,0.604,0.58
1078,2019-20,Liberty,34,30,4,0.882,6800,841,1755,581,1044,260,711,390,547,250,881,1131,446,192,95,318,456,2332,0.479,0.557,0.366,0.713,0.579,0.553
1079,2023-24,Lehigh,32,14,18,0.438,6550,829,1887,599,1173,230,714,438,596,263,874,1137,422,231,73,386,532,2326,0.439,0.511,0.322,0.735,0.536,0.5
1080,2022-23,Lehigh,30,16,14,0.533,6000,752,1698,547,1114,205,584,385,516,203,803,1006,370,187,71,353,501,2094,0.443,0.491,0.351,0.746,0.539,0.503
1081,2021-22,Lehigh,32,13,19,0.406,6425,796,1782,536,1101,260,681,338,456,222,845,1067,453,141,114,427,540,2190,0.447,0.487,0.382,0.741,0.548,0.52
1082,2020-21,Lehigh,15,4,11,0.267,3025,388,901,315,670,73,231,176,251,137,384,521,191,90,32,196,268,1025,0.431,0.47,0.316,0.701,0.502,0.471
1083,2019-20,Lehigh,32,11,21,0.344,6450,826,1846,646,1308,180,538,352,480,282,828,1110,404,174,77,442,564,2184,0.447,0.494,0.335,0.733,0.527,0.496
1084,2023-24,Le Moyne,32,15,17,0.469,6425,823,1906,508,996,315,910,357,469,270,823,1093,503,256,103,367,489,2318,0.432,0.51,0.346,0.761,0.544,0.514
1085,2023-24,Lamar,33,19,14,0.576,6700,912,2025,664,1308,248,717,496,679,412,845,1257,544,233,123,426,615,2568,0.45,0.508,0.346,0.73,0.547,0.512
1086,2022-23,Lamar,31,9,22,0.29,6250,761,1767,583,1211,178,556,404,574,364,755,1119,409,199,105,441,488,2104,0.431,0.481,0.32,0.704,0.516,0.481
1087,2021-22,Lamar,29,2,27,0.069,5800,664,1654,512,1146,152,508,298,433,320,689,1009,321,169,86,422,545,1778,0.401,0.447,0.299,0.688,0.478,0.447
1088,2020-21,Lamar,28,10,18,0.357,5650,670,1608,531,1163,139,445,364,496,269,698,967,332,200,118,396,466,1843,0.417,0.457,0.312,0.734,0.5,0.46
1089,2019-20,Lamar,32,17,15,0.531,6450,831,1903,642,1331,189,572,461,654,360,778,1138,427,284,146,467,531,2312,0.437,0.482,0.33,0.705,0.522,0.486
1090,2023-24,Lafayette,32,11,21,0.344,6500,744,1823,517,1095,227,728,295,438,279,785,1064,421,210,139,372,518,2010,0.408,0.472,0.312,0.674,0.495,0.47
1091,2022-23,Lafayette,34,11,23,0.324,6970,767,1881,469,970,298,911,288,460,284,822,1106,528,196,101,396,523,2120,0.408,0.484,0.327,0.626,0.505,0.487
1092,2021-22,Lafayette,30,10,20,0.333,6125,757,1750,494,948,263,802,257,376,241,717,958,485,188,101,331,432,2034,0.433,0.521,0.328,0.684,0.527,0.508
1093,2020-21,Lafayette,15,9,6,0.6,3100,405,928,276,570,129,358,226,281,133,392,525,243,94,51,163,280,1165,0.436,0.484,0.36,0.804,0.549,0.506
1094,2019-20,Lafayette,31,19,12,0.613,6200,798,1765,533,991,265,774,313,422,238,841,1079,473,147,138,375,442,2174,0.452,0.538,0.342,0.742,0.553,0.527
1095,2023-24,La Salle,33,16,17,0.485,6700,877,2041,596,1230,281,811,363,502,336,806,1142,484,209,110,316,550,2398,0.43,0.485,0.346,0.723,0.526,0.499
1096,2022-23,La Salle,34,15,19,0.441,6875,863,2037,615,1311,248,726,400,577,384,833,1217,408,229,110,427,606,2374,0.424,0.469,0.342,0.693,0.514,0.485
1097,2021-22,La Salle,30,11,19,0.367,6075,743,1796,514,1079,229,717,310,451,325,769,1094,401,177,128,394,517,2025,0.414,0.476,0.319,0.687,0.504,0.477
1098,2020-21,La Salle,25,9,16,0.36,5025,633,1453,438,880,195,573,241,352,234,595,829,318,186,83,361,431,1702,0.436,0.498,0.34,0.685,0.525,0.503
1099,2019-20,La Salle,30,15,15,0.5,6075,711,1718,471,1004,240,714,378,568,311,737,1048,391,241,93,440,586,2040,0.414,0.469,0.336,0.665,0.513,0.484
1100,2023-24,Kentucky,33,23,10,0.697,6675,1055,2132,728,1332,327,800,501,649,332,909,1241,579,248,207,352,577,2938,0.495,0.547,0.409,0.772,0.602,0.572
1101,2022-23,Kentucky,34,22,12,0.647,6850,929,2045,716,1432,213,613,461,653,472,867,1339,512,219,125,400,545,2532,0.454,0.5,0.347,0.706,0.538,0.506
1102,2021-22,Kentucky,34,26,8,0.765,6850,1030,2133,823,1537,207,596,434,598,441,924,1365,549,231,144,394,487,2701,0.483,0.535,0.347,0.726,0.559,0.531
1103,2020-21,Kentucky,25,9,16,0.36,5050,615,1476,455,999,160,477,371,509,300,651,951,313,157,148,349,450,1761,0.417,0.455,0.335,0.729,0.513,0.471
1104,2019-20,Kentucky,31,25,6,0.806,6250,795,1723,638,1265,157,458,560,703,300,836,1136,415,162,153,387,568,2307,0.461,0.504,0.343,0.797,0.561,0.507
1105,2023-24,Kent State,34,17,17,0.5,6925,890,2016,608,1228,282,788,482,646,377,801,1178,436,234,89,403,609,2544,0.441,0.495,0.358,0.746,0.548,0.511
1106,2022-23,Kent State,35,28,7,0.8,7023,957,2128,682,1310,275,818,476,656,386,863,1249,432,309,138,398,659,2665,0.45,0.521,0.336,0.726,0.546,0.514
1107,2021-22,Kent State,34,23,11,0.676,6800,852,1932,595,1160,257,772,462,619,353,867,1220,423,242,117,416,616,2423,0.441,0.513,0.333,0.746,0.544,0.508
1108,2020-21,Kent State,23,15,8,0.652,4625,635,1432,450,865,185,567,309,397,289,611,900,330,156,75,312,391,1764,0.443,0.52,0.326,0.778,0.544,0.508
1109,2019-20,Kent State,32,20,12,0.625,6500,886,1952,618,1161,268,791,402,553,345,812,1157,445,218,132,407,596,2442,0.454,0.532,0.339,0.727,0.551,0.523
1110,2023-24,Kennesaw State,31,15,16,0.484,6250,908,2035,616,1147,292,888,460,682,380,824,1204,460,228,126,374,623,2568,0.446,0.537,0.329,0.674,0.544,0.518
1111,2022-23,Kennesaw State,35,26,9,0.743,7075,931,2021,645,1238,286,783,478,723,337,897,1234,502,276,96,434,631,2626,0.461,0.521,0.365,0.661,0.555,0.531
1112,2021-22,Kennesaw State,31,13,18,0.419,6300,850,1836,592,1130,258,706,361,545,332,770,1102,446,221,86,383,531,2319,0.463,0.524,0.365,0.662,0.553,0.533
1113,2020-21,Kennesaw State,24,5,19,0.208,4800,571,1359,407,833,164,526,265,402,215,600,815,260,138,60,341,429,1571,0.42,0.489,0.312,0.659,0.507,0.481
1114,2019-20,Kennesaw State,29,1,28,0.034,5800,560,1580,439,1092,121,488,361,513,280,652,932,235,146,57,427,489,1602,0.354,0.402,0.248,0.704,0.439,0.393
1115,2023-24,Kansas State,34,19,15,0.559,6975,837,1919,586,1129,251,790,529,735,378,897,1275,475,202,139,503,596,2454,0.436,0.519,0.318,0.72,0.541,0.502
1116,2022-23,Kansas State,36,26,10,0.722,7325,961,2083,703,1331,258,752,562,751,355,892,1247,611,289,100,498,644,2742,0.461,0.528,0.343,0.748,0.562,0.523
1117,2021-22,Kansas State,31,14,17,0.452,6250,748,1780,487,1026,261,754,382,526,275,755,1030,386,227,51,356,530,2139,0.42,0.475,0.346,0.726,0.527,0.494
1118,2020-21,Kansas State,29,9,20,0.31,5800,649,1577,458,932,191,645,303,456,296,657,953,377,161,44,431,492,1792,0.412,0.491,0.296,0.664,0.5,0.472
1119,2019-20,Kansas State,32,11,21,0.344,6425,721,1742,508,1061,213,681,399,604,331,719,1050,397,277,78,459,611,2054,0.414,0.479,0.313,0.661,0.506,0.475
1120,2023-24,Kansas City,32,16,16,0.5,6500,813,1903,544,1092,269,811,405,568,367,795,1162,411,191,120,385,624,2300,0.427,0.498,0.332,0.713,0.529,0.498
1121,2022-23,Kansas City,32,11,21,0.344,6475,723,1844,535,1179,188,665,426,598,430,753,1183,300,192,117,432,585,2060,0.392,0.454,0.283,0.712,0.484,0.443
1122,2021-22,Kansas City,31,19,12,0.613,6200,855,1788,630,1173,225,615,376,556,209,758,967,410,230,86,325,625,2311,0.478,0.537,0.366,0.676,0.563,0.541
1123,2020-21,Kansas City,24,11,13,0.458,4800,642,1292,493,885,149,407,250,379,175,555,730,355,190,50,300,524,1683,0.497,0.557,0.366,0.66,0.572,0.555
1124,2019-20,Kansas City,30,16,14,0.533,6125,771,1684,557,1088,214,596,338,494,261,675,936,396,242,94,390,640,2094,0.458,0.512,0.359,0.684,0.546,0.521
1125,2023-24,Kansas,34,23,11,0.676,6825,960,1967,765,1380,195,587,454,630,280,948,1228,647,243,133,397,502,2569,0.488,0.554,0.332,0.721,0.567,0.538
1126,2022-23,Kansas,36,28,8,0.778,7250,1002,2142,751,1418,251,724,460,639,353,941,1294,590,317,139,444,597,2715,0.468,0.53,0.347,0.72,0.555,0.526
1127,2021-22,Kansas,40,34,6,0.85,8075,1144,2393,858,1600,286,793,555,774,438,1077,1515,613,251,172,484,637,3129,0.478,0.536,0.361,0.717,0.567,0.538
1128,2020-21,Kansas,30,21,9,0.7,6025,789,1809,562,1146,227,663,386,539,333,791,1124,415,207,119,359,460,2191,0.436,0.49,0.342,0.716,0.531,0.499
1129,2019-20,Kansas,31,28,3,0.903,6225,851,1758,652,1180,199,578,411,616,333,863,1196,432,237,145,396,454,2312,0.484,0.553,0.344,0.667,0.564,0.541
1130,2023-24,James Madison,36,32,4,0.889,7275,1073,2254,766,1402,307,852,542,771,415,975,1390,577,325,113,392,621,2995,0.476,0.546,0.36,0.703,0.572,0.544
1131,2022-23,James Madison,33,22,11,0.667,6700,933,2019,670,1268,263,751,529,748,393,864,1257,444,298,87,435,583,2658,0.462,0.528,0.35,0.707,0.56,0.527
1132,2021-22,James Madison,29,15,14,0.517,5875,804,1737,589,1114,215,623,355,509,269,701,970,388,247,61,360,476,2178,0.463,0.529,0.345,0.697,0.55,0.525
1133,2020-21,James Madison,20,13,7,0.65,4000,543,1201,377,715,166,486,310,464,220,527,747,276,149,41,243,375,1562,0.452,0.527,0.342,0.668,0.549,0.521
1134,2019-20,James Madison,30,9,21,0.3,6000,750,1787,519,1066,231,721,426,652,303,825,1128,368,187,87,373,523,2157,0.42,0.487,0.32,0.653,0.514,0.484
1135,2023-24,Jacksonville State,32,14,18,0.438,6425,803,1778,633,1271,170,507,464,661,370,808,1178,354,216,126,433,524,2240,0.452,0.498,0.335,0.702,0.535,0.499
1136,2022-23,Jacksonville State,31,13,18,0.419,6225,747,1705,466,958,281,747,391,559,318,799,1117,381,172,74,410,510,2166,0.438,0.486,0.376,0.699,0.55,0.521
1137,2021-22,Jacksonville State,32,21,11,0.656,6425,838,1796,541,1027,297,769,380,554,308,869,1177,458,199,92,419,459,2353,0.467,0.527,0.386,0.686,0.571,0.549
1138,2020-21,Jacksonville State,27,18,9,0.667,5475,723,1568,504,952,219,616,340,496,299,749,1048,383,135,94,360,413,2005,0.461,0.529,0.356,0.685,0.556,0.531
1139,2019-20,Jacksonville State,32,13,19,0.406,6425,844,1893,618,1213,226,680,380,550,354,811,1165,439,202,82,452,505,2294,0.446,0.509,0.332,0.691,0.532,0.506
1140,2023-24,Jacksonville,33,16,17,0.485,6625,835,1918,621,1268,214,650,485,688,412,797,1209,355,255,100,431,648,2371,0.435,0.49,0.329,0.705,0.528,0.491
1141,2022-23,Jacksonville,29,13,16,0.448,5800,686,1519,486,931,200,588,265,353,220,748,968,376,148,69,333,409,1837,0.452,0.522,0.34,0.751,0.545,0.517
1142,2021-22,Jacksonville,31,21,10,0.677,6225,768,1706,581,1167,187,539,358,506,336,792,1128,387,203,60,352,467,2081,0.45,0.498,0.347,0.708,0.535,0.505
1143,2020-21,Jacksonville,24,11,13,0.458,4825,577,1320,407,794,170,526,298,449,206,594,800,269,164,63,343,372,1622,0.437,0.513,0.323,0.664,0.529,0.502
1144,2019-20,Jacksonville,32,14,18,0.438,6475,778,1813,573,1170,205,643,378,564,327,890,1217,356,161,91,440,498,2139,0.429,0.49,0.319,0.67,0.514,0.486
1145,2023-24,Jackson State,32,15,17,0.469,6425,799,1923,588,1273,211,650,470,668,417,744,1161,384,239,111,428,544,2279,0.415,0.462,0.325,0.704,0.509,0.47
1146,2022-23,Jackson State,33,14,19,0.424,6691,800,1911,593,1261,207,650,425,630,384,753,1137,406,248,82,514,571,2232,0.419,0.47,0.318,0.675,0.505,0.473
1147,2021-22,Jackson State,30,11,19,0.367,6025,694,1702,539,1185,155,517,286,451,336,718,1054,325,183,117,395,512,1829,0.408,0.455,0.3,0.634,0.477,0.453
1148,2020-21,Jackson State,18,12,6,0.667,3650,397,1002,297,708,100,294,287,422,187,474,661,190,147,59,277,348,1181,0.396,0.419,0.34,0.68,0.491,0.446
1149,2019-20,Jackson State,32,15,17,0.469,6400,787,1855,644,1314,143,541,436,649,298,738,1036,362,260,117,410,627,2153,0.424,0.49,0.264,0.672,0.498,0.463
1150,2023-24,IUPUI,32,6,26,0.188,6425,775,1768,665,1324,110,444,448,609,316,628,944,332,244,67,468,558,2108,0.438,0.502,0.248,0.736,0.512,0.469
1151,2022-23,IUPUI,32,5,27,0.156,6425,786,1718,640,1226,146,492,371,537,297,714,1011,358,185,81,506,570,2089,0.458,0.522,0.297,0.691,0.529,0.5
1152,2021-22,IUPUI,29,3,26,0.103,5800,557,1467,408,956,149,511,258,387,300,613,913,303,166,74,481,513,1521,0.38,0.427,0.292,0.667,0.461,0.43
1153,2020-21,IUPUI,18,8,10,0.444,3600,452,1069,309,653,143,416,234,326,168,440,608,239,124,40,250,340,1281,0.423,0.473,0.344,0.718,0.523,0.49
1154,2019-20,IUPUI,32,7,25,0.219,6450,803,1945,549,1192,254,753,396,614,363,777,1140,431,207,79,445,571,2256,0.413,0.461,0.337,0.645,0.504,0.478
1155,2023-24,Iowa State,37,29,8,0.784,7400,1002,2164,756,1477,246,687,537,765,393,861,1254,582,382,113,387,610,2787,0.463,0.512,0.358,0.702,0.551,0.52
1156,2022-23,Iowa State,33,19,14,0.576,6650,834,1882,623,1245,211,637,352,525,380,731,1111,457,290,96,427,633,2231,0.443,0.5,0.331,0.67,0.523,0.499
1157,2021-22,Iowa State,35,22,13,0.629,7050,849,1969,615,1227,234,742,364,533,337,797,1134,513,299,109,484,639,2296,0.431,0.501,0.315,0.683,0.517,0.491
1158,2020-21,Iowa State,24,2,22,0.083,4800,591,1413,416,867,175,546,217,277,206,552,758,278,156,75,357,447,1574,0.418,0.48,0.321,0.783,0.51,0.48
1159,2019-20,Iowa State,32,12,20,0.375,6425,836,1905,609,1187,227,718,405,543,327,770,1097,443,238,135,425,517,2304,0.439,0.513,0.316,0.746,0.533,0.498
1160,2023-24,Iowa,34,19,15,0.559,6825,1025,2154,799,1510,226,644,551,712,333,877,1210,606,232,134,327,575,2827,0.476,0.529,0.351,0.774,0.567,0.528
1161,2022-23,Iowa,33,19,14,0.576,6675,941,2077,676,1298,265,779,495,671,398,809,1207,541,216,112,325,488,2642,0.453,0.521,0.34,0.738,0.551,0.517
1162,2021-22,Iowa,36,26,10,0.722,7250,1071,2322,740,1410,331,912,522,697,428,916,1344,577,264,156,332,583,2995,0.461,0.525,0.363,0.749,0.564,0.533
1163,2020-21,Iowa,31,22,9,0.71,6225,923,1961,622,1181,301,780,448,627,346,885,1231,594,173,141,294,461,2595,0.471,0.527,0.386,0.715,0.574,0.547
1164,2019-20,Iowa,31,20,11,0.645,6200,842,1868,598,1165,244,703,482,643,356,806,1162,538,191,120,375,496,2410,0.451,0.513,0.347,0.75,0.554,0.516
1165,2023-24,Iona,33,16,17,0.485,6600,857,1984,586,1216,271,768,369,566,345,706,1051,473,292,96,336,588,2354,0.432,0.482,0.353,0.652,0.522,0.5
1166,2022-23,Iona,35,27,8,0.771,7025,979,2135,732,1452,247,683,453,619,389,856,1245,520,261,192,367,568,2660,0.459,0.504,0.362,0.732,0.548,0.516
1167,2021-22,Iona,33,25,8,0.758,6650,872,1952,638,1248,234,704,504,727,377,843,1220,532,216,198,418,601,2482,0.447,0.511,0.332,0.693,0.54,0.507
1168,2020-21,Iona,18,12,6,0.667,3600,446,1010,314,629,132,381,259,348,194,469,663,245,123,75,281,389,1283,0.442,0.499,0.346,0.744,0.546,0.507
1169,2019-20,Iona,29,12,17,0.414,5875,697,1586,473,913,224,673,412,535,231,740,971,382,199,108,413,540,2030,0.439,0.518,0.333,0.77,0.552,0.51
1170,2023-24,Indiana State,39,32,7,0.821,7825,1141,2258,714,1139,427,1119,600,754,279,1104,1383,698,238,72,452,638,3309,0.505,0.627,0.382,0.796,0.632,0.6
1171,2022-23,Indiana State,36,23,13,0.639,7250,1008,2088,668,1129,340,959,499,647,249,996,1245,570,235,69,434,587,2855,0.483,0.592,0.355,0.771,0.596,0.564
1172,2021-22,Indiana State,31,11,20,0.355,6325,776,1759,506,949,270,810,362,465,192,863,1055,406,186,60,408,472,2184,0.441,0.533,0.333,0.778,0.552,0.518
1173,2020-21,Indiana State,25,15,10,0.6,5000,580,1338,431,892,149,446,353,481,207,589,796,267,164,73,302,373,1662,0.433,0.483,0.334,0.734,0.53,0.489
1174,2019-20,Indiana State,30,18,12,0.6,6025,731,1617,522,1062,209,555,381,532,227,730,957,377,165,102,343,509,2052,0.452,0.492,0.377,0.716,0.549,0.517
1175,2023-24,Indiana,33,19,14,0.576,6600,879,1848,713,1335,166,513,462,696,293,861,1154,504,171,133,400,559,2386,0.476,0.534,0.324,0.664,0.548,0.521
1176,2022-23,Indiana,35,23,12,0.657,7025,994,2044,794,1500,200,544,428,602,321,929,1250,533,203,177,402,599,2616,0.486,0.529,0.368,0.711,0.561,0.535
1177,2021-22,Indiana,35,21,14,0.6,7075,903,1988,697,1369,206,619,466,666,318,946,1264,511,197,169,414,609,2478,0.454,0.509,0.333,0.7,0.538,0.506
1178,2020-21,Indiana,27,12,15,0.444,5575,654,1510,496,1022,158,488,416,626,242,691,933,376,155,101,322,479,1882,0.433,0.485,0.324,0.665,0.521,0.485
1179,2019-20,Indiana,32,20,12,0.625,6425,812,1825,636,1285,176,540,486,716,361,849,1210,414,179,140,403,549,2286,0.445,0.495,0.326,0.679,0.528,0.493
1180,2023-24,Incarnate Word,31,8,23,0.258,6250,768,1795,532,1083,236,712,468,644,333,800,1133,377,187,128,495,589,2240,0.428,0.491,0.331,0.727,0.533,0.494
1181,2022-23,Incarnate Word,31,12,19,0.387,6275,776,1756,582,1199,194,557,448,600,284,692,976,382,259,88,425,532,2194,0.442,0.485,0.348,0.747,0.537,0.497
1182,2021-22,Incarnate Word,32,7,25,0.219,6400,737,1773,461,979,276,794,395,504,254,695,949,370,166,57,433,556,2145,0.416,0.471,0.348,0.784,0.533,0.494
1183,2020-21,Incarnate Word,22,8,14,0.364,4425,524,1178,356,729,168,449,279,397,171,514,685,269,118,41,308,396,1495,0.445,0.488,0.374,0.703,0.547,0.516
1184,2019-20,Incarnate Word,31,9,22,0.29,6300,726,1741,539,1118,187,623,411,558,298,702,1000,382,224,80,474,585,2050,0.417,0.482,0.3,0.737,0.511,0.471
1185,2023-24,Illinois–Chicago,33,12,21,0.364,6725,844,1927,557,1137,287,790,344,500,271,839,1110,459,203,176,408,583,2319,0.438,0.49,0.363,0.688,0.536,0.512
1186,2022-23,Illinois–Chicago,32,12,20,0.375,6450,747,1794,492,1020,255,774,400,611,269,768,1037,421,206,150,410,560,2149,0.416,0.482,0.329,0.655,0.516,0.487
1187,2021-22,Illinois–Chicago,30,14,16,0.467,6075,798,1815,527,979,271,836,292,414,261,741,1002,441,173,119,360,515,2159,0.44,0.538,0.324,0.705,0.537,0.514
1188,2020-21,Illinois–Chicago,22,9,13,0.409,4450,558,1301,380,757,178,544,195,296,183,583,766,297,81,68,291,409,1489,0.429,0.502,0.327,0.659,0.516,0.497
1189,2019-20,Illinois–Chicago,35,18,17,0.514,7025,880,1984,628,1237,252,747,400,584,333,977,1310,494,201,152,549,682,2412,0.444,0.508,0.337,0.685,0.533,0.507
1190,2023-24,Illinois State,32,15,17,0.469,6400,743,1752,549,1087,194,665,448,630,323,791,1114,400,178,72,360,502,2128,0.424,0.505,0.292,0.711,0.519,0.479
1191,2022-23,Illinois State,32,11,21,0.344,6500,737,1699,505,1009,232,690,421,531,280,765,1045,345,183,105,466,590,2127,0.434,0.5,0.336,0.793,0.545,0.502
1192,2021-22,Illinois State,33,13,20,0.394,6775,869,1926,610,1221,259,705,450,604,321,843,1164,406,224,156,454,573,2447,0.451,0.5,0.367,0.745,0.553,0.518
1193,2020-21,Illinois State,25,7,18,0.28,5075,679,1477,484,911,195,566,246,372,206,675,881,345,150,84,345,411,1799,0.46,0.531,0.345,0.661,0.544,0.526
1194,2019-20,Illinois State,31,10,21,0.323,6225,740,1745,482,1019,258,726,312,439,275,762,1037,373,179,77,446,529,2050,0.424,0.473,0.355,0.711,0.525,0.498
1195,2023-24,Illinois,38,29,9,0.763,7650,1104,2356,787,1448,317,908,643,874,486,1068,1554,506,166,143,401,576,3168,0.469,0.544,0.349,0.736,0.572,0.536
1196,2022-23,Illinois,33,20,13,0.606,6677,874,1946,623,1131,251,815,453,667,366,882,1248,409,229,186,426,559,2452,0.449,0.551,0.308,0.679,0.542,0.514
1197,2021-22,Illinois,33,23,10,0.697,6650,863,1925,568,1104,295,821,435,616,379,892,1271,501,171,99,408,538,2456,0.448,0.514,0.359,0.706,0.554,0.525
1198,2020-21,Illinois,31,24,7,0.774,6275,909,1819,706,1275,203,544,476,690,322,917,1239,506,176,87,404,549,2497,0.5,0.554,0.373,0.69,0.582,0.556
1199,2019-20,Illinois,31,21,10,0.677,6225,811,1831,636,1265,175,566,442,607,393,831,1224,411,151,89,375,497,2239,0.443,0.503,0.309,0.728,0.528,0.491
1200,2023-24,Idaho State,34,14,20,0.412,6925,875,1902,657,1239,218,663,429,625,337,756,1093,408,238,121,372,546,2397,0.46,0.53,0.329,0.686,0.545,0.517
1201,2022-23,Idaho State,32,11,21,0.344,6550,794,1785,549,1060,245,725,380,517,259,746,1005,392,185,90,370,564,2213,0.445,0.518,0.338,0.735,0.545,0.513
1202,2021-22,Idaho State,30,7,23,0.233,6025,673,1608,461,924,212,684,373,545,296,686,982,313,136,66,414,545,1931,0.419,0.499,0.31,0.684,0.517,0.484
1203,2020-21,Idaho State,24,13,11,0.542,4850,559,1261,393,762,166,499,353,496,243,618,861,273,108,83,357,442,1637,0.443,0.516,0.333,0.712,0.547,0.509
1204,2019-20,Idaho State,30,8,22,0.267,6075,760,1664,568,1113,192,551,381,581,291,694,985,350,137,73,405,458,2093,0.457,0.51,0.348,0.656,0.539,0.514
1205,2023-24,Idaho,32,11,21,0.344,6425,785,1778,542,1052,243,726,357,487,254,756,1010,392,179,102,367,567,2170,0.442,0.515,0.335,0.733,0.54,0.51
1206,2022-23,Idaho,32,10,22,0.313,6478,824,1747,607,1109,217,638,470,617,222,757,979,381,164,57,362,539,2335,0.472,0.547,0.34,0.762,0.572,0.534
1207,2021-22,Idaho,31,9,22,0.29,6250,780,1765,532,1098,248,667,455,619,254,806,1060,370,110,69,422,607,2263,0.442,0.485,0.372,0.735,0.55,0.512
1208,2020-21,Idaho,22,1,21,0.045,4450,489,1133,367,775,122,358,243,335,152,505,657,266,109,43,360,416,1343,0.432,0.474,0.341,0.725,0.52,0.485
1209,2019-20,Idaho,32,8,24,0.25,6425,784,1780,628,1317,156,463,362,536,261,821,1082,384,177,71,451,554,2086,0.44,0.477,0.337,0.675,0.513,0.484
1210,2023-24,Howard,35,18,17,0.514,7100,868,1932,587,1175,281,757,606,807,395,862,1257,485,212,98,541,661,2623,0.449,0.5,0.371,0.751,0.566,0.522
1211,2022-23,Howard,35,22,13,0.629,7025,934,2038,652,1284,282,754,484,679,407,845,1252,523,252,109,573,614,2634,0.458,0.508,0.374,0.713,0.558,0.527
1212,2021-22,Howard,29,16,13,0.552,5825,759,1728,514,1045,245,683,452,607,295,703,998,418,243,104,428,524,2215,0.439,0.492,0.359,0.745,0.549,0.51
1213,2020-21,Howard,5,1,4,0.2,1000,123,283,85,160,38,123,79,110,41,136,177,74,26,25,72,89,363,0.435,0.531,0.309,0.718,0.541,0.502
1214,2019-20,Howard,33,4,29,0.121,6675,808,1922,561,1204,247,718,443,637,320,768,1088,443,180,119,486,609,2306,0.42,0.466,0.344,0.695,0.518,0.485
1215,2023-24,Houston Christian,29,6,23,0.207,5825,759,1751,612,1263,147,488,409,635,346,730,1076,330,162,82,445,422,2074,0.433,0.485,0.301,0.644,0.505,0.475
1216,2022-23,Houston Baptist,32,10,22,0.313,6425,851,1863,586,1137,265,726,515,717,330,767,1097,474,184,88,489,575,2482,0.457,0.515,0.365,0.718,0.563,0.528
1217,2021-22,Houston Baptist,29,11,18,0.379,5900,762,1711,562,1090,200,621,466,655,331,718,1049,390,229,74,438,550,2190,0.445,0.516,0.322,0.711,0.542,0.504
1218,2020-21,Houston Baptist,25,6,19,0.24,5025,635,1485,433,897,202,588,304,415,228,621,849,354,176,92,418,424,1776,0.428,0.483,0.344,0.733,0.528,0.496
1219,2019-20,Houston Baptist,29,4,25,0.138,5825,798,1800,582,1206,216,594,511,684,353,693,1046,370,164,64,487,586,2323,0.443,0.483,0.364,0.747,0.547,0.503
1220,2023-24,Houston,37,32,5,0.865,7475,981,2233,695,1412,286,821,472,687,497,877,1374,484,362,178,330,658,2720,0.439,0.492,0.348,0.687,0.531,0.503
1221,2022-23,Houston,37,33,4,0.892,7400,1010,2203,726,1368,284,835,466,636,474,967,1441,544,293,182,370,618,2770,0.458,0.531,0.34,0.733,0.553,0.523
1222,2021-22,Houston,38,32,6,0.842,7675,1054,2267,756,1386,298,881,438,657,506,976,1482,617,305,196,423,652,2844,0.465,0.545,0.338,0.667,0.551,0.531
1223,2020-21,Houston,32,28,4,0.875,6400,854,1961,563,1138,291,823,435,595,458,838,1296,446,255,149,341,575,2434,0.435,0.495,0.354,0.731,0.542,0.51
1224,2019-20,Houston,31,23,8,0.742,6225,788,1868,572,1227,216,641,449,615,447,839,1286,400,161,151,369,608,2241,0.422,0.466,0.337,0.73,0.519,0.48
1225,2023-24,Holy Cross,33,10,23,0.303,6625,815,1857,566,1153,249,704,315,476,273,806,1079,365,133,109,364,532,2194,0.439,0.491,0.354,0.662,0.527,0.506
1226,2022-23,Holy Cross,32,10,22,0.313,6425,812,1862,593,1263,219,599,293,471,255,785,1040,398,203,89,387,514,2136,0.436,0.47,0.366,0.622,0.512,0.495
1227,2021-22,Holy Cross,31,9,22,0.29,6200,742,1793,561,1266,181,527,357,504,310,738,1048,315,184,118,386,523,2022,0.414,0.443,0.343,0.708,0.497,0.464
1228,2020-21,Holy Cross,16,5,11,0.313,3225,423,952,312,638,111,314,173,248,150,373,523,193,110,63,206,305,1130,0.444,0.489,0.354,0.698,0.528,0.503
1229,2019-20,Holy Cross,32,3,29,0.094,6475,789,1829,570,1140,219,689,309,461,280,753,1033,371,156,88,458,569,2106,0.431,0.5,0.318,0.67,0.514,0.491
1230,2023-24,Hofstra,33,20,13,0.606,6625,904,1918,574,1028,330,890,311,413,254,827,1081,507,204,115,344,480,2449,0.471,0.558,0.371,0.753,0.579,0.557
1231,2022-23,Hofstra,35,25,10,0.714,7075,1001,2084,698,1258,303,826,314,425,271,910,1181,504,218,148,376,503,2619,0.48,0.555,0.367,0.739,0.573,0.553
1232,2021-22,Hofstra,32,21,11,0.656,6450,928,2004,623,1108,305,896,333,418,263,799,1062,495,255,87,330,478,2494,0.463,0.562,0.34,0.797,0.566,0.539
1233,2020-21,Hofstra,23,13,10,0.565,4625,595,1342,421,815,174,527,317,443,241,575,816,293,152,68,279,368,1683,0.443,0.517,0.33,0.716,0.542,0.508
1234,2019-20,Hofstra,34,26,8,0.765,6800,895,1991,613,1238,282,753,524,669,352,832,1184,419,235,73,383,482,2596,0.45,0.495,0.375,0.783,0.562,0.52
1235,2023-24,High Point,36,27,9,0.75,7326,999,2163,699,1284,300,879,722,928,476,964,1440,427,182,120,399,651,3020,0.462,0.544,0.341,0.778,0.58,0.531
1236,2022-23,High Point,31,14,17,0.452,6207,813,1834,579,1114,234,720,452,722,362,817,1179,383,203,152,438,573,2312,0.443,0.52,0.325,0.626,0.531,0.507
1237,2021-22,High Point,32,14,18,0.438,6575,808,1829,600,1208,208,621,401,627,322,820,1142,400,207,149,427,555,2225,0.442,0.497,0.335,0.64,0.523,0.499
1238,2020-21,High Point,24,9,15,0.375,4825,564,1357,449,961,115,396,357,520,279,573,852,292,157,91,303,428,1600,0.416,0.467,0.29,0.687,0.499,0.458
1239,2019-20,High Point,32,9,23,0.281,6450,711,1751,513,1132,198,619,490,701,360,748,1108,391,164,114,459,590,2110,0.406,0.453,0.32,0.699,0.506,0.463
1240,2023-24,Hawaii,34,20,14,0.588,6875,843,1841,578,1065,265,776,507,706,287,868,1155,414,157,88,423,594,2458,0.458,0.543,0.341,0.718,0.565,0.53
1241,2022-23,Hawaii,33,22,11,0.667,6675,772,1799,552,1132,220,667,444,594,320,845,1165,367,151,125,401,528,2208,0.429,0.488,0.33,0.747,0.53,0.49
1242,2021-22,Hawaii,28,17,11,0.607,5600,667,1514,439,878,228,636,366,492,258,727,985,344,99,60,365,471,1928,0.441,0.5,0.358,0.744,0.552,0.516
1243,2020-21,Hawaii,21,11,10,0.524,4275,534,1208,370,752,164,456,271,376,217,535,752,246,119,32,291,350,1503,0.442,0.492,0.36,0.721,0.542,0.51
1244,2019-20,Hawaii,30,17,13,0.567,6025,731,1715,516,1063,215,652,380,540,287,722,1009,403,164,63,392,527,2057,0.426,0.485,0.33,0.704,0.522,0.489
1245,2023-24,Harvard,27,14,13,0.519,5450,665,1516,465,920,200,596,370,527,250,691,941,351,168,117,328,400,1900,0.439,0.505,0.336,0.702,0.538,0.505
1246,2022-23,Harvard,28,14,14,0.5,5650,700,1593,516,997,184,596,330,493,299,716,1015,370,211,107,381,408,1914,0.439,0.518,0.309,0.669,0.524,0.497
1247,2021-22,Harvard,26,13,13,0.5,5275,676,1564,455,895,221,669,285,411,243,660,903,295,198,63,321,409,1858,0.432,0.508,0.33,0.693,0.528,0.503
1248,2019-20,Harvard,29,21,8,0.724,5900,763,1680,554,1045,209,635,379,541,305,805,1110,343,187,153,403,505,2114,0.454,0.53,0.329,0.701,0.546,0.516
1249,2022-23,Hartford,28,5,23,0.179,5600,659,1543,453,923,206,620,233,362,255,631,886,364,179,105,403,395,1757,0.427,0.491,0.332,0.644,0.512,0.494
1250,2021-22,Hartford,32,12,20,0.375,6425,799,1778,502,974,297,804,339,491,248,789,1037,390,193,101,390,479,2234,0.449,0.515,0.369,0.69,0.555,0.533
1251,2020-21,Hartford,24,15,9,0.625,4800,562,1305,383,751,179,554,267,373,191,607,798,264,166,54,315,386,1570,0.431,0.51,0.323,0.716,0.53,0.499
1252,2019-20,Hartford,33,18,15,0.545,6625,773,1850,520,1108,253,742,402,572,264,857,1121,428,241,78,444,575,2201,0.418,0.469,0.341,0.703,0.519,0.486
1253,2023-24,Hampton,33,9,24,0.273,6600,853,2011,612,1252,241,759,422,591,372,849,1221,421,193,123,411,537,2369,0.424,0.489,0.318,0.714,0.517,0.484
1254,2022-23,Hampton,32,8,24,0.25,6425,759,1934,531,1225,228,709,437,636,335,763,1098,352,138,101,354,587,2183,0.392,0.433,0.322,0.687,0.488,0.451
1255,2021-22,Hampton,28,9,19,0.321,5650,628,1572,467,1023,161,549,397,567,234,731,965,292,145,113,352,515,1814,0.399,0.457,0.293,0.7,0.493,0.451
1256,2020-21,Hampton,25,11,14,0.44,5000,619,1437,434,880,185,557,298,411,196,648,844,292,152,149,318,426,1721,0.431,0.493,0.332,0.725,0.527,0.495
1257,2019-20,Hampton,34,15,19,0.441,6850,924,2025,711,1384,213,641,574,821,347,901,1248,497,171,128,397,650,2635,0.456,0.514,0.332,0.699,0.546,0.509
1258,2023-24,Green Bay,32,18,14,0.563,6450,780,1742,495,902,285,840,364,504,283,778,1061,412,140,69,384,552,2209,0.448,0.549,0.339,0.722,0.557,0.53
1259,2022-23,Green Bay,32,3,29,0.094,6426,656,1665,438,941,218,724,368,524,235,670,905,350,162,76,447,541,1898,0.394,0.465,0.301,0.702,0.496,0.459
1260,2021-22,Green Bay,30,5,25,0.167,6000,668,1593,512,1040,156,553,360,504,268,633,901,322,149,83,387,462,1852,0.419,0.492,0.282,0.714,0.505,0.468
1261,2020-21,Green Bay,25,8,17,0.32,5150,656,1507,486,996,170,511,308,411,228,589,817,352,138,90,269,405,1790,0.435,0.488,0.333,0.749,0.526,0.492
1262,2019-20,Green Bay,33,17,16,0.515,6675,968,2109,716,1426,252,683,506,669,325,875,1200,534,228,102,411,634,2694,0.459,0.502,0.369,0.756,0.555,0.519
1263,2023-24,Grand Canyon,35,30,5,0.857,7025,924,2008,679,1279,245,729,676,903,412,923,1335,424,289,192,430,625,2769,0.46,0.531,0.336,0.749,0.568,0.521
1264,2022-23,Grand Canyon,36,24,12,0.667,7250,933,2018,610,1175,323,843,517,722,364,953,1317,452,177,115,430,648,2706,0.462,0.519,0.383,0.716,0.573,0.542
1265,2021-22,Grand Canyon,31,23,8,0.742,6200,784,1822,531,1102,253,720,383,564,394,855,1249,396,206,68,403,550,2204,0.43,0.482,0.351,0.679,0.527,0.5
1266,2020-21,Grand Canyon,24,17,7,0.708,4800,676,1384,513,888,163,496,297,434,254,704,958,390,116,72,308,412,1812,0.488,0.578,0.329,0.684,0.57,0.547
1267,2019-20,Grand Canyon,30,13,17,0.433,6050,740,1641,560,1100,180,541,456,611,224,752,976,355,144,39,344,485,2116,0.451,0.509,0.333,0.746,0.548,0.506
1268,2023-24,Grambling State,36,21,15,0.583,7291,860,1955,675,1408,185,547,531,750,346,812,1158,354,266,115,473,577,2436,0.44,0.479,0.338,0.708,0.527,0.487
1269,2022-23,Grambling State,33,24,9,0.727,6624,811,1785,637,1296,174,489,480,745,364,832,1196,405,242,136,475,624,2276,0.454,0.492,0.356,0.644,0.532,0.503
1270,2021-22,Grambling State,32,12,20,0.375,6400,749,1842,586,1325,163,517,431,607,333,812,1145,350,211,107,455,585,2092,0.407,0.442,0.315,0.71,0.491,0.451
1271,2020-21,Grambling State,24,12,12,0.5,4825,562,1313,437,936,125,377,368,553,207,620,827,337,195,73,371,433,1617,0.428,0.467,0.332,0.665,0.513,0.476
1272,2019-20,Grambling State,32,17,15,0.531,6400,832,1837,677,1331,155,506,461,676,329,816,1145,412,239,128,456,589,2280,0.453,0.509,0.306,0.682,0.528,0.495
1273,2023-24,Gonzaga,35,27,8,0.771,7000,1120,2162,877,1488,243,674,476,660,379,976,1355,585,233,135,342,546,2959,0.518,0.589,0.361,0.721,0.598,0.574
1274,2022-23,Gonzaga,37,31,6,0.838,7425,1188,2282,909,1545,279,737,532,768,383,993,1376,602,268,127,397,613,3187,0.521,0.588,0.379,0.693,0.602,0.582
1275,2021-22,Gonzaga,32,28,4,0.875,6400,1045,2004,783,1296,262,708,438,614,309,1032,1341,578,205,186,370,497,2790,0.521,0.604,0.37,0.713,0.608,0.587
1276,2020-21,Gonzaga,32,31,1,0.969,6425,1079,1965,839,1313,240,652,513,703,289,900,1189,601,254,90,385,521,2911,0.549,0.639,0.368,0.73,0.633,0.61
1277,2019-20,Gonzaga,33,31,2,0.939,6625,1048,2035,802,1398,246,637,543,789,375,949,1324,550,243,127,368,484,2885,0.515,0.574,0.386,0.688,0.599,0.575
1278,2023-24,Georgia Tech,32,14,18,0.438,6500,810,1924,556,1144,254,780,398,561,367,852,1219,425,140,128,393,527,2272,0.421,0.486,0.326,0.709,0.519,0.487
1279,2022-23,Georgia Tech,33,15,18,0.455,6625,855,2019,596,1246,259,773,332,477,349,806,1155,463,197,134,349,524,2301,0.423,0.478,0.335,0.696,0.512,0.488
1280,2021-22,Georgia Tech,32,12,20,0.375,6500,823,1866,595,1220,228,646,321,460,284,804,1088,438,249,82,419,576,2195,0.441,0.488,0.353,0.698,0.527,0.502
1281,2020-21,Georgia Tech,26,17,9,0.654,5325,722,1514,530,963,192,551,312,430,205,582,787,412,236,90,290,410,1948,0.477,0.55,0.348,0.726,0.567,0.54
1282,2019-20,Georgia Tech,31,17,14,0.548,6250,781,1727,620,1211,161,516,403,595,299,822,1121,425,220,142,502,591,2126,0.452,0.512,0.312,0.677,0.529,0.499
1283,2023-24,Georgia State,31,14,17,0.452,6250,856,1967,622,1249,234,718,424,560,325,835,1160,366,179,89,301,543,2370,0.435,0.498,0.326,0.757,0.531,0.495
1284,2022-23,Georgia State,31,10,21,0.323,6225,745,1789,581,1233,164,556,414,581,343,727,1070,342,179,111,400,528,2068,0.416,0.471,0.295,0.713,0.501,0.462
1285,2021-22,Georgia State,29,18,11,0.621,5875,722,1806,501,1136,221,670,384,533,385,699,1084,391,255,130,339,466,2049,0.4,0.441,0.33,0.72,0.498,0.461
1286,2020-21,Georgia State,22,16,6,0.727,4500,649,1386,471,889,178,497,291,425,250,576,826,369,157,97,255,365,1767,0.468,0.53,0.358,0.685,0.556,0.532
1287,2019-20,Georgia State,32,19,13,0.594,6450,879,2005,601,1238,278,767,463,626,371,808,1179,467,251,135,452,684,2499,0.438,0.485,0.362,0.74,0.543,0.508
1288,2023-24,Georgia Southern,33,9,24,0.273,6675,847,1971,538,1093,309,878,417,570,347,783,1130,354,228,132,436,662,2420,0.43,0.492,0.352,0.732,0.54,0.508
1289,2022-23,Georgia Southern,33,17,16,0.515,6626,840,1926,633,1267,207,659,370,539,325,840,1165,343,232,94,378,551,2257,0.436,0.5,0.314,0.686,0.517,0.49
1290,2021-22,Georgia Southern,29,13,16,0.448,5850,714,1599,544,1040,170,559,329,484,283,723,1006,347,216,100,415,509,1927,0.447,0.523,0.304,0.68,0.527,0.5
1291,2020-21,Georgia Southern,26,13,13,0.5,5350,686,1536,492,928,194,608,294,463,306,658,964,324,210,101,374,444,1860,0.447,0.53,0.319,0.635,0.53,0.51
1292,2019-20,Georgia Southern,33,20,13,0.606,6600,874,1979,614,1187,260,792,486,721,325,850,1175,407,260,127,428,542,2494,0.442,0.517,0.328,0.674,0.537,0.507
1293,2023-24,Georgia,37,20,17,0.541,7425,943,2195,643,1312,300,883,578,803,366,953,1319,436,237,121,421,598,2764,0.43,0.49,0.34,0.72,0.536,0.498
1294,2022-23,Georgia,32,16,16,0.5,6427,728,1774,513,1096,215,678,522,718,347,798,1145,358,202,85,423,513,2193,0.41,0.468,0.317,0.727,0.518,0.471
1295,2021-22,Georgia,32,6,26,0.188,6400,763,1725,558,1087,205,638,503,673,269,777,1046,444,167,69,462,481,2234,0.442,0.513,0.321,0.747,0.546,0.502
1296,2020-21,Georgia,26,14,12,0.538,5225,734,1603,569,1094,165,509,381,553,318,655,973,389,220,64,433,484,2014,0.458,0.52,0.324,0.689,0.54,0.509
1297,2019-20,Georgia,32,16,16,0.5,6500,875,1941,652,1198,223,743,455,648,376,832,1208,431,228,104,471,604,2428,0.451,0.544,0.3,0.702,0.54,0.508
1298,2023-24,Georgetown,32,9,23,0.281,6450,775,1867,510,1101,265,766,452,633,390,700,1090,391,183,98,390,533,2267,0.415,0.463,0.346,0.714,0.523,0.486
1299,2022-23,Georgetown,32,7,25,0.219,6450,818,1934,633,1335,185,599,404,563,345,806,1151,380,197,146,392,462,2225,0.423,0.474,0.309,0.718,0.505,0.471
1300,2021-22,Georgetown,31,6,25,0.194,6200,770,1924,533,1231,237,693,415,558,394,761,1155,366,222,119,414,502,2192,0.4,0.433,0.342,0.744,0.501,0.462
1301,2020-21,Georgetown,26,13,13,0.5,5225,644,1521,428,929,216,592,353,469,298,736,1034,333,153,101,395,413,1857,0.423,0.461,0.365,0.753,0.532,0.494
1302,2019-20,Georgetown,32,15,17,0.469,6400,840,1921,634,1326,206,595,503,652,375,847,1222,479,200,130,433,511,2389,0.437,0.478,0.346,0.771,0.535,0.491
1303,2023-24,George Washington,32,15,17,0.469,6575,841,1901,554,1105,287,796,488,654,293,887,1180,395,189,153,397,465,2457,0.442,0.501,0.361,0.746,0.555,0.518
1304,2022-23,George Washington,32,16,16,0.5,6525,869,1849,641,1139,228,710,475,644,284,834,1118,406,182,109,403,526,2441,0.47,0.563,0.321,0.738,0.566,0.532
1305,2021-22,George Washington,30,12,18,0.4,6075,758,1769,544,1135,214,634,321,460,249,749,998,368,207,125,379,512,2051,0.428,0.479,0.338,0.698,0.516,0.489
1306,2020-21,George Washington,17,5,12,0.294,3425,411,928,309,613,102,315,234,335,136,446,582,194,107,46,233,247,1158,0.443,0.504,0.324,0.699,0.533,0.498
1307,2019-20,George Washington,32,12,20,0.375,6500,728,1726,493,993,235,733,395,566,249,808,1057,380,172,130,420,532,2086,0.422,0.496,0.321,0.698,0.523,0.49
1308,2023-24,George Mason,32,20,12,0.625,6400,791,1720,573,1083,218,637,473,637,323,829,1152,365,175,110,378,527,2273,0.46,0.529,0.342,0.743,0.562,0.523
1309,2022-23,George Mason,33,20,13,0.606,6650,800,1774,560,1089,240,685,428,657,302,878,1180,452,152,103,453,568,2268,0.451,0.514,0.35,0.651,0.544,0.519
1310,2021-22,George Mason,30,14,16,0.467,6125,751,1685,471,902,280,783,340,490,248,794,1042,424,152,95,367,480,2122,0.446,0.522,0.358,0.694,0.553,0.529
1311,2020-21,George Mason,22,13,9,0.591,4525,578,1347,418,860,160,487,253,394,254,580,834,287,159,95,282,353,1569,0.429,0.486,0.329,0.642,0.511,0.488
1312,2019-20,George Mason,32,17,15,0.531,6425,765,1805,576,1183,189,622,429,621,380,812,1192,349,194,149,435,537,2148,0.424,0.487,0.304,0.691,0.511,0.476
1313,2023-24,Gardner-Webb,33,17,16,0.515,6679,867,1992,618,1270,249,722,443,702,370,890,1260,419,193,78,385,633,2426,0.435,0.487,0.345,0.631,0.522,0.498
1314,2022-23,Gardner-Webb,31,15,16,0.484,6300,813,1741,617,1158,196,583,370,592,310,787,1097,399,222,146,403,594,2192,0.467,0.533,0.336,0.625,0.542,0.523
1315,2021-22,Gardner-Webb,31,18,13,0.581,6200,784,1767,554,1068,230,699,356,508,273,870,1143,409,225,147,416,567,2154,0.444,0.519,0.329,0.701,0.536,0.509
1316,2020-21,Gardner-Webb,26,11,15,0.423,5200,651,1465,419,822,232,643,303,439,239,656,895,339,153,125,304,492,1837,0.444,0.51,0.361,0.69,0.549,0.524
1317,2019-20,Gardner-Webb,32,16,16,0.5,6575,810,1809,556,1103,254,706,444,640,299,819,1118,438,201,150,399,520,2318,0.448,0.504,0.36,0.694,0.549,0.518
1318,2023-24,Furman,33,17,16,0.515,6700,911,2054,591,1066,320,988,481,661,371,876,1247,535,235,95,391,528,2623,0.444,0.554,0.324,0.728,0.554,0.521
1319,2022-23,Furman,36,28,8,0.778,7275,1016,2129,676,1141,340,988,539,727,351,911,1262,600,238,115,397,604,2911,0.477,0.592,0.344,0.741,0.588,0.557
1320,2021-22,Furman,34,22,12,0.647,6950,945,2038,544,984,401,1054,349,461,316,810,1126,591,281,119,357,496,2640,0.464,0.553,0.38,0.757,0.585,0.562
1321,2020-21,Furman,25,16,9,0.64,5025,730,1499,488,791,242,708,288,398,223,656,879,416,205,84,313,428,1990,0.487,0.617,0.342,0.724,0.589,0.568
1322,2019-20,Furman,32,25,7,0.781,6450,881,1857,579,998,302,859,393,561,249,761,1010,475,264,90,366,495,2457,0.474,0.58,0.352,0.701,0.579,0.556
1323,2023-24,Fresno State,33,12,21,0.364,6700,812,1794,583,1104,229,690,380,555,260,783,1043,411,203,81,415,520,2233,0.453,0.528,0.332,0.685,0.543,0.516
1324,2022-23,Fresno State,31,11,20,0.355,6200,720,1673,510,992,210,681,324,420,248,690,938,382,196,103,359,499,1974,0.43,0.514,0.308,0.771,0.527,0.493
1325,2021-22,Fresno State,36,23,13,0.639,7325,855,1916,605,1174,250,742,424,596,318,908,1226,431,220,101,402,555,2384,0.446,0.515,0.337,0.711,0.542,0.511
1326,2020-21,Fresno State,24,12,12,0.5,4825,552,1289,388,790,164,499,323,485,257,596,853,249,158,70,344,427,1591,0.428,0.491,0.329,0.666,0.524,0.492
1327,2019-20,Fresno State,30,11,19,0.367,6125,713,1704,429,869,284,835,365,519,329,783,1112,372,147,113,383,496,2075,0.418,0.494,0.34,0.703,0.532,0.502
1328,2023-24,Fordham,33,13,20,0.394,6725,798,1993,533,1152,265,841,464,701,430,795,1225,419,265,156,426,666,2325,0.4,0.463,0.315,0.662,0.5,0.467
1329,2022-23,Fordham,33,25,8,0.758,6650,797,1901,545,1109,252,792,530,715,356,863,1219,418,238,160,446,647,2376,0.419,0.491,0.318,0.741,0.53,0.486
1330,2021-22,Fordham,32,16,16,0.5,6500,737,1870,500,1071,237,799,404,556,327,852,1179,379,234,119,421,565,2115,0.394,0.467,0.297,0.727,0.496,0.457
1331,2020-21,Fordham,14,2,12,0.143,2800,257,716,178,422,79,294,132,197,95,320,415,153,87,28,187,221,725,0.359,0.422,0.269,0.67,0.448,0.414
1332,2019-20,Fordham,31,9,22,0.29,6275,646,1683,423,981,223,702,301,455,236,785,1021,351,219,80,385,535,1816,0.384,0.431,0.318,0.662,0.478,0.45
1333,2023-24,Florida State,33,17,16,0.515,6625,903,1995,703,1365,200,630,520,735,336,762,1098,406,305,142,392,651,2526,0.453,0.515,0.317,0.707,0.539,0.503
1334,2022-23,Florida State,32,9,23,0.281,6400,802,1840,593,1207,209,633,406,559,278,728,1006,430,197,125,388,519,2219,0.436,0.491,0.33,0.726,0.527,0.493
1335,2021-22,Florida State,31,17,14,0.548,6250,799,1842,591,1214,208,628,395,558,352,729,1081,445,264,151,387,506,2201,0.434,0.487,0.331,0.708,0.522,0.49
1336,2020-21,Florida State,25,18,7,0.72,5050,693,1461,501,951,192,510,351,474,272,646,918,363,182,127,359,459,1929,0.474,0.527,0.376,0.741,0.572,0.54
1337,2019-20,Florida State,31,26,5,0.839,6250,844,1848,614,1193,230,655,418,557,350,749,1099,409,273,162,410,542,2336,0.457,0.515,0.351,0.75,0.553,0.519
1338,2023-24,Florida International,33,11,22,0.333,6625,882,2019,598,1179,284,840,381,569,344,700,1044,465,337,135,451,595,2429,0.437,0.507,0.338,0.67,0.531,0.507
1339,2022-23,Florida International,32,14,18,0.438,6500,867,1861,648,1190,219,671,386,541,275,733,1008,397,290,128,473,547,2339,0.466,0.545,0.326,0.713,0.552,0.525
1340,2021-22,Florida International,32,15,17,0.469,6525,813,1892,505,1012,308,880,330,470,307,814,1121,443,205,128,447,494,2264,0.43,0.499,0.35,0.702,0.535,0.511
1341,2020-21,Florida International,26,9,17,0.346,5275,690,1604,417,788,273,816,261,392,252,595,847,390,219,105,380,463,1914,0.43,0.529,0.335,0.666,0.535,0.515
1342,2019-20,Florida International,32,19,13,0.594,6425,898,1968,612,1149,286,819,373,574,347,794,1141,469,280,206,482,553,2455,0.456,0.533,0.349,0.65,0.548,0.529
1343,2023-24,Florida Gulf Coast,32,14,18,0.438,6425,827,1817,577,1113,250,704,349,502,316,782,1098,375,193,108,363,464,2253,0.455,0.518,0.355,0.695,0.548,0.524
1344,2022-23,Florida Gulf Coast,32,17,15,0.531,6450,805,1844,510,1012,295,832,375,507,301,806,1107,409,219,104,365,497,2280,0.437,0.504,0.355,0.74,0.547,0.517
1345,2021-22,Florida Gulf Coast,34,22,12,0.647,6950,944,2081,597,1089,347,992,406,601,380,939,1319,534,227,164,458,504,2641,0.454,0.548,0.35,0.676,0.558,0.537
1346,2020-21,Florida Gulf Coast,18,10,8,0.556,3600,483,1126,337,627,146,499,180,271,206,494,700,246,134,77,265,280,1292,0.429,0.537,0.293,0.664,0.515,0.494
1347,2019-20,Florida Gulf Coast,32,10,22,0.313,6475,731,1782,498,1041,233,741,284,412,314,781,1095,408,195,140,495,508,1979,0.41,0.478,0.314,0.689,0.5,0.476
1348,2023-24,Florida Atlantic,34,25,9,0.735,6950,992,2074,708,1264,284,810,521,724,396,898,1294,505,244,105,388,546,2789,0.478,0.56,0.351,0.72,0.577,0.547
1349,2022-23,Florida Atlantic,39,35,4,0.897,7850,1084,2326,709,1302,375,1024,492,684,425,1094,1519,562,252,100,460,613,3035,0.466,0.545,0.366,0.719,0.572,0.547
1350,2021-22,Florida Atlantic,34,19,15,0.559,6825,907,2004,608,1154,299,850,406,570,372,862,1234,454,251,97,437,575,2519,0.453,0.527,0.352,0.712,0.554,0.527
1351,2020-21,Florida Atlantic,23,13,10,0.565,4625,652,1409,429,822,223,587,269,407,287,642,929,335,175,63,318,415,1796,0.463,0.522,0.38,0.661,0.56,0.542
1352,2019-20,Florida Atlantic,32,17,15,0.531,6475,822,1928,556,1115,266,813,365,519,341,828,1169,391,234,66,427,542,2275,0.426,0.499,0.327,0.703,0.523,0.495
1353,2023-24,Florida A&M,29,6,23,0.207,5900,727,1679,557,1184,170,495,325,464,278,724,1002,414,173,82,442,541,1949,0.433,0.47,0.343,0.7,0.513,0.484
1354,2022-23,Florida A&M,29,7,22,0.241,5825,595,1536,428,1003,167,533,343,496,295,658,953,280,191,105,464,551,1700,0.387,0.427,0.313,0.692,0.48,0.442
1355,2021-22,Florida A&M,30,13,17,0.433,6050,733,1711,596,1258,137,453,349,495,269,709,978,360,188,92,375,532,1952,0.428,0.474,0.302,0.705,0.502,0.468
1356,2020-21,Florida A&M,20,8,12,0.4,4000,500,1126,405,823,95,303,219,336,206,499,705,265,130,50,338,364,1314,0.444,0.492,0.314,0.652,0.511,0.486
1357,2019-20,Florida A&M,27,12,15,0.444,5525,664,1582,557,1205,107,377,389,613,323,621,944,272,202,51,415,519,1824,0.42,0.462,0.284,0.635,0.487,0.454
1358,2023-24,Florida,36,24,12,0.667,7325,1077,2351,797,1539,280,812,646,903,527,995,1522,546,241,189,420,664,3080,0.458,0.518,0.345,0.715,0.554,0.518
1359,2022-23,Florida,33,16,17,0.485,6625,830,1904,610,1203,220,701,471,657,278,865,1143,406,225,171,371,533,2351,0.436,0.507,0.314,0.717,0.53,0.494
1360,2021-22,Florida,34,20,14,0.588,6850,825,1936,556,1049,269,887,481,654,377,767,1144,435,284,171,422,543,2400,0.426,0.53,0.303,0.735,0.534,0.496
1361,2020-21,Florida,25,15,10,0.6,5025,663,1407,494,932,169,475,359,477,245,637,882,293,180,131,375,464,1854,0.471,0.53,0.356,0.753,0.567,0.531
1362,2019-20,Florida,31,19,12,0.613,6250,791,1729,570,1093,221,636,425,588,313,767,1080,368,178,121,369,528,2228,0.457,0.522,0.347,0.723,0.555,0.521
1363,2023-24,FDU,32,15,17,0.469,6450,843,2012,575,1200,268,812,476,680,364,827,1191,484,263,81,408,571,2430,0.419,0.479,0.33,0.7,0.52,0.486
1364,2022-23,Fairleigh Dickinson,37,21,16,0.568,7475,1045,2312,743,1436,302,876,471,626,427,844,1271,545,295,74,425,696,2863,0.452,0.517,0.345,0.752,0.549,0.517
1365,2021-22,Fairleigh Dickinson,26,4,22,0.154,5250,632,1555,454,1005,178,550,306,432,268,592,860,307,168,77,357,475,1748,0.406,0.452,0.324,0.708,0.497,0.464
1366,2020-21,Fairleigh Dickinson,24,9,15,0.375,4850,645,1432,451,915,194,517,317,445,244,569,813,287,182,93,340,439,1801,0.45,0.493,0.375,0.712,0.548,0.518
1367,2019-20,Fairleigh Dickinson,30,11,19,0.367,6050,787,1740,565,1118,222,622,371,513,273,734,1007,356,191,99,389,489,2167,0.452,0.505,0.357,0.723,0.546,0.516
1368,2023-24,Fairfield,37,24,13,0.649,7400,991,2221,649,1278,342,943,470,620,368,871,1239,497,314,82,394,531,2794,0.446,0.508,0.363,0.758,0.555,0.523
1369,2022-23,Fairfield,31,13,18,0.419,6275,690,1681,512,1060,178,621,454,627,305,740,1045,296,170,114,367,472,2012,0.41,0.483,0.287,0.724,0.508,0.463
1370,2021-22,Fairfield,33,15,18,0.455,6675,820,1891,569,1152,251,739,348,494,313,828,1141,394,179,101,364,526,2239,0.434,0.494,0.34,0.704,0.527,0.5
1371,2020-21,Fairfield,27,10,17,0.37,5450,580,1456,417,939,163,517,345,496,265,684,949,271,125,62,349,480,1668,0.398,0.444,0.315,0.696,0.493,0.454
1372,2019-20,Fairfield,32,12,20,0.375,6500,651,1669,513,1183,138,486,417,600,327,772,1099,276,164,88,440,524,1857,0.39,0.434,0.284,0.695,0.475,0.431
1373,2023-24,Evansville,35,17,18,0.486,7050,915,2043,678,1338,237,705,414,577,270,908,1178,451,227,108,406,535,2481,0.448,0.507,0.336,0.718,0.535,0.506
1374,2022-23,Evansville,32,5,27,0.156,6400,729,1839,530,1221,199,618,340,540,252,752,1004,328,224,62,392,520,1997,0.396,0.434,0.322,0.63,0.476,0.451
1375,2021-22,Evansville,30,6,24,0.2,6125,629,1581,384,838,245,743,272,384,144,672,816,316,178,61,336,440,1775,0.398,0.458,0.33,0.708,0.503,0.475
1376,2020-21,Evansville,25,9,16,0.36,5075,571,1299,331,662,240,637,237,330,149,521,670,291,122,56,274,377,1619,0.44,0.5,0.377,0.718,0.556,0.532
1377,2019-20,Evansville,32,9,23,0.281,6550,746,1769,505,1019,241,750,416,570,224,781,1005,392,152,74,406,534,2149,0.422,0.496,0.321,0.73,0.527,0.49
1378,2023-24,Elon,32,13,19,0.406,6400,824,1848,549,1067,275,781,416,588,331,751,1082,418,201,85,379,503,2339,0.446,0.515,0.352,0.707,0.55,0.52
1379,2022-23,Elon,32,8,24,0.25,6400,762,1791,544,1069,218,722,352,497,281,798,1079,389,196,69,395,515,2094,0.425,0.509,0.302,0.708,0.517,0.486
1380,2021-22,Elon,32,10,22,0.313,6400,766,1800,493,1002,273,798,342,464,284,777,1061,401,155,78,417,651,2147,0.426,0.492,0.342,0.737,0.531,0.501
1381,2020-21,Elon,19,10,9,0.526,3800,449,1083,295,609,154,474,197,266,166,486,652,206,108,39,219,359,1249,0.415,0.484,0.325,0.741,0.516,0.486
1382,2019-20,Elon,34,13,21,0.382,6825,805,1932,459,980,346,952,381,518,282,826,1108,453,160,64,392,660,2337,0.417,0.468,0.363,0.736,0.536,0.506
1383,2023-24,Eastern Washington,32,21,11,0.656,6425,894,1783,621,1034,273,749,525,681,258,825,1083,562,191,115,422,579,2586,0.501,0.601,0.364,0.771,0.614,0.578
1384,2022-23,Eastern Washington,34,23,11,0.676,6800,931,1901,631,1064,300,837,445,589,305,917,1222,523,176,107,461,591,2607,0.49,0.593,0.358,0.756,0.598,0.569
1385,2021-22,Eastern Washington,34,18,16,0.529,6850,905,1998,605,1142,300,856,501,666,309,938,1247,537,189,94,451,631,2613,0.453,0.53,0.35,0.752,0.565,0.528
1386,2020-21,Eastern Washington,24,16,8,0.667,4800,667,1425,463,851,204,574,341,431,178,670,848,365,115,70,277,407,1879,0.468,0.544,0.355,0.791,0.576,0.54
1387,2019-20,Eastern Washington,31,23,8,0.742,6250,913,1986,625,1160,288,826,395,569,328,858,1186,544,221,112,398,578,2509,0.46,0.539,0.349,0.694,0.556,0.532
1388,2023-24,Eastern Michigan,31,13,18,0.419,6275,783,1825,605,1240,178,585,303,454,321,748,1069,321,179,77,361,508,2047,0.429,0.488,0.304,0.667,0.502,0.478
1389,2022-23,Eastern Michigan,31,8,23,0.258,6250,803,1827,611,1219,192,608,441,575,270,704,974,299,194,67,367,587,2239,0.44,0.501,0.316,0.767,0.533,0.492
1390,2021-22,Eastern Michigan,31,10,21,0.323,6350,782,1816,586,1180,196,636,383,551,258,821,1079,314,181,99,429,542,2143,0.431,0.497,0.308,0.695,0.516,0.485
1391,2020-21,Eastern Michigan,18,6,12,0.333,3600,448,1077,320,666,128,411,243,326,169,425,594,198,159,43,221,274,1267,0.416,0.48,0.311,0.745,0.514,0.475
1392,2019-20,Eastern Michigan,32,16,16,0.5,6400,725,1703,545,1060,180,643,448,714,313,772,1085,311,314,105,458,544,2078,0.426,0.514,0.28,0.627,0.509,0.479
1393,2023-24,Eastern Kentucky,31,17,14,0.548,6225,917,1993,674,1315,243,678,427,628,410,834,1244,453,196,190,356,502,2504,0.46,0.513,0.358,0.68,0.546,0.521
1394,2022-23,Eastern Kentucky,37,23,14,0.622,7525,1098,2487,780,1560,318,927,395,599,503,978,1481,552,296,176,444,586,2909,0.441,0.5,0.343,0.659,0.525,0.505
1395,2021-22,Eastern Kentucky,31,13,18,0.419,6325,887,2125,524,1096,363,1029,320,453,386,736,1122,485,316,113,359,513,2457,0.417,0.478,0.353,0.706,0.525,0.503
1396,2020-21,Eastern Kentucky,29,22,7,0.759,5900,871,1946,592,1168,279,778,351,497,306,727,1033,461,299,103,373,533,2372,0.448,0.507,0.359,0.706,0.544,0.519
1397,2019-20,Eastern Kentucky,33,16,17,0.485,6600,857,2084,589,1249,268,835,482,664,334,779,1113,397,307,70,461,602,2464,0.411,0.472,0.321,0.726,0.513,0.476
1398,2023-24,Eastern Illinois,32,14,18,0.438,6400,822,1951,643,1391,179,560,381,521,349,782,1131,413,258,95,331,567,2204,0.421,0.462,0.32,0.731,0.501,0.467
1399,2022-23,Eastern Illinois,31,9,22,0.29,6225,797,1800,635,1307,162,493,378,593,288,764,1052,449,260,105,419,559,2134,0.443,0.486,0.329,0.637,0.513,0.488
1400,2021-22,Eastern Illinois,31,5,26,0.161,6200,623,1567,438,999,185,568,315,494,220,692,912,367,196,93,496,451,1746,0.398,0.438,0.326,0.638,0.485,0.457
1401,2020-21,Eastern Illinois,27,9,18,0.333,5475,707,1623,521,1049,186,574,274,417,285,659,944,360,193,88,383,435,1874,0.436,0.497,0.324,0.657,0.515,0.493
1402,2019-20,Eastern Illinois,32,17,15,0.531,6450,890,1944,675,1315,215,629,382,579,342,827,1169,449,245,141,402,526,2377,0.458,0.513,0.342,0.66,0.536,0.513
1403,2023-24,East Tennessee State,35,19,16,0.543,7025,866,2131,594,1255,272,876,498,730,486,864,1350,399,269,163,433,638,2502,0.406,0.473,0.311,0.682,0.505,0.47
1404,2022-23,East Tennessee State,32,12,20,0.375,6425,821,1814,618,1181,203,633,366,546,343,779,1122,390,195,99,420,491,2211,0.453,0.523,0.321,0.67,0.533,0.509
1405,2021-22,East Tennessee State,32,15,17,0.469,6425,853,1921,572,1119,281,802,319,440,350,765,1115,420,216,89,360,475,2306,0.444,0.511,0.35,0.725,0.541,0.517
1406,2020-21,East Tennessee State,25,13,12,0.52,5025,620,1416,419,841,201,575,295,423,253,644,897,295,184,63,339,431,1736,0.438,0.498,0.35,0.697,0.537,0.509
1407,2019-20,East Tennessee State,34,30,4,0.882,6800,919,1936,659,1184,260,752,495,713,370,836,1206,471,278,121,412,598,2593,0.475,0.557,0.346,0.694,0.57,0.542
1408,2023-24,East Carolina,33,15,18,0.455,6650,803,1903,585,1207,218,696,463,669,393,761,1154,406,260,92,358,516,2287,0.422,0.485,0.313,0.692,0.515,0.479
1409,2022-23,East Carolina,33,16,17,0.485,6600,769,1896,520,1108,249,788,484,704,403,820,1223,433,214,87,435,583,2271,0.406,0.469,0.316,0.688,0.509,0.471
1410,2021-22,East Carolina,30,15,15,0.5,6050,700,1724,475,1048,225,676,436,578,299,757,1056,442,203,92,389,487,2063,0.406,0.453,0.333,0.754,0.516,0.471
1411,2020-21,East Carolina,19,8,11,0.421,3825,449,1094,340,735,109,359,262,362,189,464,653,303,117,59,240,325,1269,0.41,0.463,0.304,0.724,0.501,0.46
1412,2019-20,East Carolina,31,11,20,0.355,6250,741,1759,579,1182,162,577,467,647,297,798,1095,424,202,93,426,642,2111,0.421,0.49,0.281,0.722,0.511,0.467
1413,2023-24,Duquesne,37,25,12,0.676,7398,921,2110,642,1289,279,821,490,681,389,899,1288,497,277,160,433,634,2611,0.436,0.498,0.34,0.72,0.536,0.503
1414,2022-23,Duquesne,33,20,13,0.606,6610,897,2052,595,1226,302,826,376,542,410,767,1177,505,266,124,395,614,2472,0.437,0.485,0.366,0.694,0.535,0.511
1415,2021-22,Duquesne,30,6,24,0.2,6100,742,1842,555,1228,187,614,285,403,342,682,1024,300,199,131,344,416,1956,0.403,0.452,0.305,0.707,0.481,0.454
1416,2020-21,Duquesne,18,9,9,0.5,3600,438,1040,323,655,115,385,214,329,205,449,654,241,121,80,240,310,1205,0.421,0.493,0.299,0.65,0.504,0.476
1417,2019-20,Duquesne,30,21,9,0.7,6075,758,1711,523,973,235,738,395,562,300,738,1038,428,207,161,378,463,2146,0.443,0.538,0.318,0.703,0.542,0.512
1418,2023-24,Duke,36,27,9,0.75,7200,1004,2112,706,1321,298,791,524,725,383,936,1319,551,235,132,349,571,2830,0.475,0.534,0.377,0.723,0.576,0.546
1419,2022-23,Duke,36,27,9,0.75,7225,936,2072,691,1341,245,731,475,620,432,960,1392,526,204,163,432,549,2592,0.452,0.515,0.335,0.766,0.548,0.511
1420,2021-22,Duke,39,32,7,0.821,7825,1158,2357,850,1516,308,841,498,675,410,1070,1480,642,249,219,400,532,3122,0.491,0.561,0.366,0.738,0.583,0.557
1421,2020-21,Duke,24,13,11,0.542,4850,692,1479,491,908,201,571,239,346,269,582,851,390,197,109,307,410,1824,0.468,0.541,0.352,0.691,0.555,0.536
1422,2019-20,Duke,31,25,6,0.806,6300,920,1957,703,1340,217,617,501,696,394,850,1244,479,258,188,409,557,2558,0.47,0.525,0.352,0.72,0.559,0.526
1423,2023-24,Drexel,32,20,12,0.625,6475,861,1886,645,1258,216,628,408,565,369,884,1253,406,161,127,346,491,2346,0.457,0.513,0.344,0.722,0.544,0.514
1424,2022-23,Drexel,32,17,15,0.531,6525,773,1794,544,1069,229,725,360,527,330,790,1120,374,180,103,373,464,2135,0.431,0.509,0.316,0.683,0.522,0.495
1425,2021-22,Drexel,29,15,14,0.517,5850,796,1718,585,1109,211,609,309,435,247,746,993,362,138,87,316,440,2112,0.463,0.528,0.346,0.71,0.549,0.525
1426,2020-21,Drexel,20,12,8,0.6,4000,514,1100,369,709,145,391,234,300,174,503,677,298,91,48,256,298,1407,0.467,0.52,0.371,0.78,0.566,0.533
1427,2019-20,Drexel,33,14,19,0.424,6625,821,1860,580,1170,241,690,371,530,344,818,1162,475,186,93,481,538,2254,0.441,0.496,0.349,0.7,0.534,0.506
1428,2023-24,Drake,35,28,7,0.8,7175,992,2079,692,1260,300,819,513,681,278,924,1202,559,226,56,337,570,2797,0.477,0.549,0.366,0.753,0.582,0.549
1429,2022-23,Drake,35,27,8,0.771,7150,952,2032,674,1281,278,751,435,567,278,972,1250,478,187,92,368,522,2617,0.469,0.526,0.37,0.767,0.569,0.537
1430,2021-22,Drake,36,25,11,0.694,7350,979,2126,726,1390,253,736,449,595,356,893,1249,427,252,115,389,611,2660,0.46,0.522,0.344,0.755,0.552,0.52
1431,2020-21,Drake,31,26,5,0.839,6250,908,1878,690,1284,218,594,320,449,317,803,1120,423,216,92,320,487,2354,0.483,0.537,0.367,0.713,0.563,0.542
1432,2019-20,Drake,34,20,14,0.588,6825,854,1864,609,1153,245,711,406,569,255,894,1149,507,187,132,438,566,2359,0.458,0.528,0.345,0.714,0.553,0.524
1433,2021-22,Dixie State,31,13,18,0.419,6225,795,1866,576,1168,219,698,438,645,333,860,1193,479,208,75,466,584,2247,0.426,0.493,0.314,0.679,0.517,0.485
1434,2020-21,Dixie State,21,8,13,0.381,4200,514,1227,386,809,128,418,305,427,200,540,740,321,143,43,320,439,1461,0.419,0.477,0.306,0.714,0.511,0.471
1435,2023-24,Detroit Mercy,32,1,31,0.031,6450,761,1806,574,1140,187,666,402,547,286,659,945,346,222,78,427,553,2111,0.421,0.504,0.281,0.735,0.511,0.473
1436,2022-23,Detroit Mercy,33,14,19,0.424,6650,876,2024,538,1149,338,875,437,569,433,779,1212,413,202,64,390,529,2527,0.433,0.468,0.386,0.768,0.551,0.516
1437,2021-22,Detroit Mercy,30,14,16,0.467,6000,752,1715,439,878,313,837,305,393,278,670,948,362,176,58,348,463,2122,0.438,0.5,0.374,0.776,0.558,0.53
1438,2020-21,Detroit Mercy,22,12,10,0.545,4425,598,1290,373,715,225,575,262,326,197,522,719,315,150,54,253,314,1683,0.464,0.522,0.391,0.804,0.582,0.551
1439,2019-20,Detroit Mercy,31,8,23,0.258,6225,724,1850,461,1035,263,815,464,593,360,758,1118,322,179,94,421,520,2175,0.391,0.445,0.323,0.782,0.51,0.462
1440,2023-24,DePaul,32,3,29,0.094,6400,725,1714,525,1117,200,597,421,574,233,718,951,392,168,99,435,482,2071,0.423,0.47,0.335,0.733,0.521,0.481
1441,2022-23,DePaul,33,10,23,0.303,6700,838,1961,565,1219,273,742,400,541,305,765,1070,457,211,156,427,604,2349,0.427,0.463,0.368,0.739,0.53,0.497
1442,2021-22,DePaul,31,15,16,0.484,6225,816,1883,612,1239,204,644,436,629,367,827,1194,354,193,155,380,488,2272,0.433,0.494,0.317,0.693,0.521,0.488
1443,2020-21,DePaul,19,5,14,0.263,3850,481,1154,378,827,103,327,185,273,229,488,717,217,130,74,300,374,1250,0.417,0.457,0.315,0.678,0.487,0.461
1444,2019-20,DePaul,32,16,16,0.5,6450,832,1906,651,1327,181,579,417,634,371,820,1191,434,257,159,469,611,2262,0.437,0.491,0.313,0.658,0.512,0.484
1445,2023-24,Denver,34,17,17,0.5,6925,946,2103,652,1258,294,845,569,779,348,865,1213,444,211,132,340,573,2755,0.45,0.518,0.348,0.73,0.557,0.52
1446,2022-23,Denver,32,15,17,0.469,6500,835,1716,691,1274,144,442,511,713,290,836,1126,363,177,98,479,544,2325,0.487,0.542,0.326,0.717,0.566,0.529
1447,2021-22,Denver,32,11,21,0.344,6475,816,1773,584,1142,232,631,393,564,241,791,1032,394,167,107,414,557,2257,0.46,0.511,0.368,0.697,0.553,0.526
1448,2020-21,Denver,21,2,19,0.095,4250,519,1171,378,769,141,402,287,398,156,480,636,250,120,54,311,431,1466,0.443,0.492,0.351,0.721,0.539,0.503
1449,2019-20,Denver,31,7,24,0.226,6250,770,1734,608,1230,162,504,433,628,221,816,1037,347,182,71,428,627,2135,0.444,0.494,0.321,0.689,0.525,0.491
1450,2023-24,Delaware State,34,15,19,0.441,6925,851,1961,693,1467,158,494,541,766,385,785,1170,413,285,66,503,574,2401,0.434,0.472,0.32,0.706,0.516,0.474
1451,2022-23,Delaware State,30,6,24,0.2,6050,714,1725,543,1183,171,542,340,494,336,711,1047,372,209,79,481,551,1939,0.414,0.459,0.315,0.688,0.495,0.463
1452,2021-22,Delaware State,28,2,26,0.071,5625,633,1567,464,1047,169,520,322,479,278,709,987,271,203,112,489,504,1757,0.404,0.443,0.325,0.672,0.49,0.458
1453,2020-21,Delaware State,19,3,16,0.158,3825,468,1183,316,691,152,492,257,357,205,473,678,216,123,69,321,404,1345,0.396,0.457,0.309,0.72,0.497,0.46
1454,2019-20,Delaware State,32,6,26,0.188,6450,824,2004,575,1213,249,791,453,661,335,807,1142,334,220,71,488,663,2350,0.411,0.474,0.315,0.685,0.507,0.473
1455,2023-24,Delaware,33,19,14,0.576,6625,891,1917,664,1239,227,678,407,576,304,874,1178,454,178,100,356,496,2416,0.465,0.536,0.335,0.707,0.551,0.524
1456,2022-23,Delaware,33,17,16,0.515,6650,816,1859,598,1179,218,680,448,616,286,783,1069,389,228,131,374,540,2298,0.439,0.507,0.321,0.727,0.534,0.498
1457,2021-22,Delaware,35,22,13,0.629,7050,909,1940,648,1188,261,752,489,657,298,840,1138,440,233,129,440,547,2568,0.469,0.545,0.347,0.744,0.57,0.536
1458,2020-21,Delaware,15,7,8,0.467,3000,347,793,240,472,107,321,212,297,131,395,526,188,69,54,215,262,1013,0.438,0.508,0.333,0.714,0.542,0.505
1459,2019-20,Delaware,33,22,11,0.667,6625,881,1833,630,1128,251,705,439,579,252,855,1107,431,180,109,423,544,2452,0.481,0.559,0.356,0.758,0.582,0.549
1460,2023-24,Dayton,33,25,8,0.758,6625,831,1752,521,975,310,777,476,643,265,842,1107,483,182,129,343,447,2448,0.474,0.534,0.399,0.74,0.595,0.563
1461,2022-23,Dayton,34,22,12,0.647,6850,833,1784,608,1119,225,665,443,634,321,908,1229,518,163,149,411,470,2334,0.467,0.543,0.338,0.699,0.56,0.53
1462,2021-22,Dayton,35,24,11,0.686,7025,901,1883,672,1248,229,635,392,574,322,910,1232,504,194,135,433,488,2423,0.478,0.538,0.361,0.683,0.562,0.539
1463,2020-21,Dayton,24,14,10,0.583,4925,592,1239,400,723,192,516,298,418,161,631,792,325,108,47,346,369,1674,0.478,0.553,0.372,0.713,0.582,0.555
1464,2019-20,Dayton,31,29,2,0.935,6275,905,1725,656,1053,249,672,421,585,242,843,1085,546,176,109,377,529,2480,0.525,0.623,0.371,0.72,0.619,0.597
1465,2023-24,Davidson,32,15,17,0.469,6500,783,1816,548,1067,235,749,441,602,295,814,1109,403,207,112,338,511,2242,0.431,0.514,0.314,0.733,0.533,0.496
1466,2022-23,Davidson,32,16,16,0.5,6475,785,1774,569,1110,216,664,450,602,265,789,1054,420,172,41,347,485,2236,0.443,0.513,0.325,0.748,0.543,0.503
1467,2021-22,Davidson,34,27,7,0.794,6825,908,1887,607,1109,301,778,450,597,251,910,1161,498,157,88,333,504,2567,0.481,0.547,0.387,0.754,0.591,0.561
1468,2020-21,Davidson,22,13,9,0.591,4425,573,1214,357,620,216,594,217,316,197,561,758,332,113,57,236,327,1579,0.472,0.576,0.364,0.687,0.579,0.561
1469,2019-20,Davidson,30,16,14,0.533,6150,755,1667,483,926,272,741,400,525,239,753,992,422,164,80,331,482,2182,0.453,0.522,0.367,0.762,0.569,0.534
1470,2023-24,Dartmouth,27,6,21,0.222,5400,594,1447,403,821,191,626,291,422,200,698,898,332,120,95,344,374,1670,0.411,0.491,0.305,0.69,0.507,0.477
1471,2022-23,Dartmouth,28,10,18,0.357,5675,719,1626,491,941,228,685,332,475,236,740,976,360,153,113,404,476,1998,0.442,0.522,0.333,0.699,0.54,0.512
1472,2021-22,Dartmouth,25,9,16,0.36,5075,608,1459,386,804,222,655,271,351,210,617,827,261,166,84,288,403,1709,0.417,0.48,0.339,0.772,0.526,0.493
1473,2019-20,Dartmouth,29,12,17,0.414,5850,700,1582,499,953,201,629,293,433,195,820,1015,364,134,74,354,483,1894,0.442,0.524,0.32,0.677,0.53,0.506
1474,2023-24,Creighton,35,25,10,0.714,7175,1016,2101,641,1083,375,1018,408,518,294,1040,1334,588,134,143,372,403,2815,0.484,0.592,0.368,0.788,0.6,0.573
1475,2022-23,Creighton,37,24,13,0.649,7450,1014,2164,695,1262,319,902,481,614,306,1063,1369,581,185,152,429,486,2828,0.469,0.551,0.354,0.783,0.576,0.542
1476,2021-22,Creighton,35,23,12,0.657,7075,896,2002,661,1239,235,763,395,535,336,999,1335,466,192,149,492,476,2422,0.448,0.533,0.308,0.738,0.537,0.506
1477,2020-21,Creighton,31,22,9,0.71,6250,878,1862,585,1051,293,811,306,478,259,849,1108,485,216,103,341,476,2355,0.472,0.557,0.361,0.64,0.564,0.55
1478,2019-20,Creighton,31,24,7,0.774,6225,866,1839,564,1056,302,783,394,533,246,833,1079,489,203,79,337,472,2428,0.471,0.534,0.386,0.739,0.58,0.553
1479,2023-24,Cornell,30,22,8,0.733,6000,895,1836,585,944,310,892,363,502,287,776,1063,544,250,79,366,549,2463,0.487,0.62,0.348,0.723,0.594,0.572
1480,2022-23,Cornell,28,17,11,0.607,5625,816,1738,516,887,300,851,355,490,291,673,964,489,272,63,348,466,2287,0.47,0.582,0.353,0.724,0.58,0.556
1481,2021-22,Cornell,26,15,11,0.577,5225,735,1575,484,854,251,721,338,478,258,727,985,450,206,76,370,486,2059,0.467,0.567,0.348,0.707,0.571,0.546
1482,2019-20,Cornell,27,7,20,0.259,5475,669,1519,475,922,194,597,286,409,226,640,866,380,182,78,313,460,1818,0.44,0.515,0.325,0.699,0.531,0.504
1483,2023-24,Coppin State,29,2,27,0.069,5850,585,1571,432,1031,153,540,355,489,283,590,873,240,222,81,455,513,1678,0.372,0.419,0.283,0.726,0.465,0.421
1484,2022-23,Coppin State,32,9,23,0.281,6500,779,1790,511,997,268,793,478,665,206,767,973,361,246,81,477,629,2304,0.435,0.513,0.338,0.719,0.547,0.51
1485,2021-22,Coppin State,32,9,23,0.281,6400,715,1851,441,927,274,924,438,640,250,844,1094,353,258,96,461,539,2142,0.386,0.476,0.297,0.684,0.497,0.46
1486,2020-21,Coppin State,22,9,13,0.409,4400,529,1287,336,651,193,636,351,564,164,632,796,286,188,71,348,394,1602,0.411,0.516,0.303,0.622,0.515,0.486
1487,2019-20,Coppin State,31,11,20,0.355,6250,736,1872,489,993,247,879,390,613,291,890,1181,315,209,94,445,546,2109,0.393,0.492,0.281,0.636,0.487,0.459
1488,2023-24,Connecticut,40,37,3,0.925,8000,1177,2367,837,1416,340,951,562,756,469,1084,1553,748,246,217,383,650,3256,0.497,0.591,0.358,0.743,0.597,0.569
1489,2022-23,Connecticut,39,31,8,0.795,7800,1082,2333,729,1360,353,973,547,719,507,1027,1534,684,245,190,503,692,3064,0.464,0.536,0.363,0.761,0.573,0.539
1490,2021-22,Connecticut,33,23,10,0.697,6725,880,2021,635,1324,245,697,464,616,455,878,1333,463,196,212,388,554,2469,0.435,0.48,0.352,0.753,0.534,0.496
1491,2020-21,Connecticut,23,15,8,0.652,4625,602,1388,447,925,155,463,291,403,311,568,879,297,142,121,268,432,1650,0.434,0.483,0.335,0.722,0.522,0.49
1492,2019-20,Connecticut,31,19,12,0.613,6400,782,1862,566,1195,216,667,478,644,393,781,1174,400,220,185,439,577,2258,0.42,0.474,0.324,0.742,0.521,0.478
1493,2023-24,Columbia,27,13,14,0.481,5400,749,1597,518,981,231,616,349,477,265,699,964,471,209,62,330,437,2078,0.469,0.528,0.375,0.732,0.57,0.541
1494,2022-23,Columbia,29,7,22,0.241,5849,696,1728,470,1014,226,714,348,487,296,702,998,340,196,58,401,485,1966,0.403,0.464,0.317,0.715,0.502,0.468
1495,2021-22,Columbia,26,4,22,0.154,5225,651,1530,453,974,198,556,252,402,264,654,918,313,154,53,396,434,1752,0.425,0.465,0.356,0.627,0.509,0.49
1496,2019-20,Columbia,30,6,24,0.2,6075,744,1819,542,1148,202,671,298,408,228,803,1031,328,164,93,337,465,1988,0.409,0.472,0.301,0.73,0.494,0.465
1497,2023-24,Colorado State,36,25,11,0.694,7250,980,2024,716,1243,264,781,483,642,283,920,1203,648,226,113,376,613,2707,0.484,0.576,0.338,0.752,0.581,0.549
1498,2022-23,Colorado State,33,15,18,0.455,6678,873,1790,622,1101,251,689,394,529,197,817,1014,545,187,81,368,537,2391,0.488,0.565,0.364,0.745,0.586,0.558
1499,2021-22,Colorado State,31,25,6,0.806,6250,821,1710,580,1035,241,675,392,507,208,774,982,442,198,95,313,466,2275,0.48,0.56,0.357,0.773,0.583,0.551
1500,2020-21,Colorado State,28,20,8,0.714,5600,715,1536,480,870,235,666,407,514,212,753,965,408,164,75,378,465,2072,0.465,0.552,0.353,0.792,0.582,0.542
1501,2019-20,Colorado State,32,20,12,0.625,6500,841,1793,583,1088,258,705,475,700,284,859,1143,497,209,64,418,489,2417,0.469,0.536,0.366,0.679,0.569,0.541
1502,2023-24,Colorado,37,26,11,0.703,7475,1049,2121,795,1472,254,649,583,744,368,999,1367,600,221,80,467,548,2935,0.495,0.54,0.391,0.784,0.593,0.554
1503,2022-23,Colorado,35,18,17,0.514,7000,894,2059,665,1347,229,712,428,616,388,912,1300,454,261,128,463,566,2445,0.434,0.494,0.322,0.695,0.52,0.49
1504,2021-22,Colorado,33,21,12,0.636,6650,817,1847,590,1227,227,620,484,640,329,894,1223,441,181,105,447,516,2345,0.442,0.481,0.366,0.756,0.545,0.504
1505,2020-21,Colorado,32,23,9,0.719,6400,828,1815,582,1154,246,661,438,535,312,801,1113,436,167,88,364,526,2340,0.456,0.504,0.372,0.819,0.565,0.524
1506,2019-20,Colorado,32,21,11,0.656,6450,777,1778,536,1091,241,687,473,643,322,857,1179,422,183,98,422,470,2268,0.437,0.491,0.351,0.736,0.544,0.505
1507,2023-24,College of Charleston,35,27,8,0.771,7025,1006,2278,638,1206,368,1072,452,626,457,935,1392,536,219,108,348,558,2832,0.442,0.529,0.343,0.722,0.55,0.522
1508,2022-23,College of Charleston,35,31,4,0.886,7052,959,2202,611,1151,348,1051,538,723,472,939,1411,478,259,109,418,590,2804,0.436,0.531,0.331,0.744,0.551,0.515
1509,2021-22,College of Charleston,32,17,15,0.531,6450,895,2039,635,1273,260,766,452,619,440,851,1291,422,255,88,500,658,2502,0.439,0.499,0.339,0.73,0.536,0.503
1510,2020-21,College of Charleston,19,9,10,0.474,3900,481,1066,323,644,158,422,221,311,156,467,623,201,100,53,197,324,1341,0.451,0.502,0.374,0.711,0.552,0.525
1511,2019-20,College of Charleston,31,17,14,0.548,6200,755,1717,518,1034,237,683,429,564,238,768,1006,337,207,78,334,523,2176,0.44,0.501,0.347,0.761,0.548,0.509
1512,2023-24,Colgate,35,25,10,0.714,7000,929,1979,657,1222,272,757,368,540,286,959,1245,526,227,122,368,468,2498,0.469,0.538,0.359,0.681,0.559,0.538
1513,2022-23,Colgate,35,26,9,0.743,7000,1042,2038,756,1329,286,709,363,549,279,900,1179,637,248,100,357,438,2733,0.511,0.569,0.403,0.661,0.594,0.581
1514,2021-22,Colgate,35,23,12,0.657,7025,964,2034,617,1176,347,858,371,532,309,957,1266,598,214,126,397,507,2646,0.474,0.525,0.404,0.697,0.579,0.559
1515,2020-21,Colgate,16,14,2,0.875,3225,495,1005,347,638,148,367,225,311,152,486,638,282,113,55,173,259,1363,0.493,0.544,0.403,0.723,0.591,0.566
1516,2019-20,Colgate,34,25,9,0.735,6825,932,2079,590,1122,342,957,382,511,341,905,1246,491,206,98,370,514,2588,0.448,0.526,0.357,0.748,0.557,0.531
1517,2023-24,Coastal Carolina,31,9,22,0.29,6250,835,1880,634,1254,201,626,409,616,353,897,1250,395,178,97,420,496,2280,0.444,0.506,0.321,0.664,0.525,0.498
1518,2022-23,Coastal Carolina,31,11,20,0.355,6250,816,1880,593,1175,223,705,418,533,349,804,1153,383,188,99,379,497,2273,0.434,0.505,0.316,0.784,0.533,0.493
1519,2021-22,Coastal Carolina,33,19,14,0.576,6675,872,1938,626,1245,246,693,414,595,398,920,1318,445,220,121,435,473,2404,0.45,0.503,0.355,0.696,0.541,0.513
1520,2020-21,Coastal Carolina,26,18,8,0.692,5250,732,1604,511,986,221,618,382,533,352,778,1130,404,213,103,394,435,2067,0.456,0.518,0.358,0.717,0.556,0.525
1521,2019-20,Coastal Carolina,33,16,17,0.485,6600,915,2030,673,1311,242,719,501,700,440,889,1329,446,248,92,530,727,2573,0.451,0.513,0.337,0.716,0.545,0.51
1522,2023-24,Cleveland State,36,21,15,0.583,7250,1005,2246,773,1549,232,697,475,711,455,812,1267,477,297,140,370,658,2717,0.447,0.499,0.333,0.668,0.526,0.499
1523,2022-23,Cleveland State,35,21,14,0.6,7125,958,2110,780,1530,178,580,418,614,438,804,1242,465,242,119,406,582,2512,0.454,0.51,0.307,0.681,0.523,0.496
1524,2021-22,Cleveland State,31,20,11,0.645,6325,853,1783,656,1181,197,602,433,645,345,746,1091,513,268,104,420,566,2336,0.478,0.555,0.327,0.671,0.559,0.534
1525,2020-21,Cleveland State,27,19,8,0.704,5525,701,1558,529,1023,172,535,340,507,284,650,934,371,188,69,348,524,1914,0.45,0.517,0.321,0.671,0.532,0.505
1526,2019-20,Cleveland State,32,11,21,0.344,6450,738,1772,618,1364,120,408,457,688,370,750,1120,379,246,84,487,648,2053,0.416,0.453,0.294,0.664,0.489,0.45
1527,2023-24,Clemson,36,24,12,0.667,7250,991,2115,695,1271,296,844,507,650,326,982,1308,533,165,138,363,585,2785,0.469,0.547,0.351,0.78,0.575,0.539
1528,2022-23,Clemson,34,23,11,0.676,6850,899,1923,617,1148,282,775,460,586,252,944,1196,485,175,107,376,589,2540,0.467,0.537,0.364,0.785,0.577,0.541
1529,2021-22,Clemson,33,17,16,0.515,6650,851,1868,595,1162,256,706,409,556,281,862,1143,470,195,77,364,521,2367,0.456,0.512,0.363,0.736,0.555,0.524
1530,2020-21,Clemson,24,16,8,0.667,4825,562,1323,364,749,198,574,236,307,206,577,783,319,146,69,303,374,1558,0.425,0.486,0.345,0.769,0.53,0.5
1531,2019-20,Clemson,31,16,15,0.516,6275,735,1717,484,920,251,797,341,497,248,797,1045,401,211,74,386,472,2062,0.428,0.526,0.315,0.686,0.528,0.501
1532,2023-24,Cincinnati,37,22,15,0.595,7500,1023,2310,743,1461,280,849,439,638,492,968,1460,540,240,164,445,555,2765,0.443,0.509,0.33,0.688,0.529,0.503
1533,2022-23,Cincinnati,36,23,13,0.639,7250,1022,2281,708,1387,314,894,418,592,403,938,1341,559,226,142,384,570,2776,0.448,0.51,0.351,0.706,0.542,0.517
1534,2021-22,Cincinnati,33,18,15,0.545,6600,812,2012,543,1159,269,853,398,595,379,847,1226,433,208,127,346,577,2291,0.404,0.469,0.315,0.669,0.499,0.47
1535,2020-21,Cincinnati,23,12,11,0.522,4600,566,1339,403,815,163,524,290,442,245,587,832,344,155,87,336,435,1585,0.423,0.494,0.311,0.656,0.512,0.484
1536,2019-20,Cincinnati,30,20,10,0.667,6200,763,1713,566,1095,197,618,459,678,329,802,1131,437,196,146,432,540,2182,0.445,0.517,0.319,0.677,0.536,0.503
1537,2023-24,Chicago State,32,13,19,0.406,6425,771,1816,570,1175,201,641,481,676,389,685,1074,354,277,103,422,559,2224,0.425,0.485,0.314,0.712,0.52,0.48
1538,2022-23,Chicago State,31,11,20,0.355,6225,760,1757,504,1002,256,755,404,555,365,725,1090,379,175,83,422,561,2180,0.433,0.503,0.339,0.728,0.539,0.505
1539,2021-22,Chicago State,32,7,25,0.219,6400,700,1791,457,1007,243,784,344,526,367,700,1067,303,175,72,474,629,1987,0.391,0.454,0.31,0.654,0.487,0.459
1540,2020-21,Chicago State,9,0,9,0.0,1800,180,497,129,294,51,203,88,126,54,180,234,89,49,13,140,178,499,0.362,0.439,0.251,0.698,0.448,0.413
1541,2019-20,Chicago State,29,4,25,0.138,5800,596,1446,434,939,162,507,427,592,207,641,848,300,144,73,513,593,1781,0.412,0.462,0.32,0.721,0.516,0.468
1542,2023-24,Chattanooga,33,21,12,0.636,6675,892,1915,543,944,349,971,448,601,305,901,1206,447,208,121,393,524,2581,0.466,0.575,0.359,0.745,0.586,0.557
1543,2022-23,Chattanooga,35,18,17,0.514,7025,924,2042,526,985,398,1057,456,639,335,933,1268,536,200,121,407,552,2702,0.452,0.534,0.377,0.714,0.576,0.55
1544,2021-22,Chattanooga,35,27,8,0.771,7050,956,2059,680,1259,276,800,408,547,378,886,1264,449,252,75,384,547,2596,0.464,0.54,0.345,0.746,0.56,0.531
1545,2020-21,Chattanooga,26,18,8,0.692,5250,667,1522,449,915,218,607,336,429,217,664,881,319,178,48,289,370,1888,0.438,0.491,0.359,0.783,0.547,0.51
1546,2019-20,Chattanooga,33,20,13,0.606,6625,868,1907,587,1120,281,787,393,552,301,861,1162,456,158,49,395,506,2410,0.455,0.524,0.357,0.712,0.556,0.529
1547,2023-24,Charlotte,31,19,12,0.613,6250,748,1655,547,1020,201,635,434,576,260,746,1006,407,168,105,301,479,2131,0.452,0.536,0.317,0.753,0.552,0.513
1548,2022-23,Charlotte,36,22,14,0.611,7325,885,1871,594,1099,291,772,349,465,231,835,1066,469,199,90,382,489,2410,0.473,0.54,0.377,0.751,0.576,0.551
1549,2021-22,Charlotte,31,17,14,0.548,6200,781,1698,548,1023,233,675,376,475,220,749,969,433,149,90,356,436,2171,0.46,0.536,0.345,0.792,0.564,0.529
1550,2020-21,Charlotte,25,9,16,0.36,5125,545,1261,402,820,143,441,354,484,172,606,778,282,136,73,335,364,1587,0.432,0.49,0.324,0.731,0.532,0.489
1551,2019-20,Charlotte,29,16,13,0.552,5875,671,1480,486,936,185,544,395,562,188,716,904,351,221,99,402,443,1922,0.453,0.519,0.34,0.703,0.55,0.516
1552,2023-24,Charleston Southern,30,10,20,0.333,6000,715,1727,507,1098,208,629,390,530,301,765,1066,306,115,90,366,512,2028,0.414,0.462,0.331,0.736,0.512,0.474
1553,2022-23,Charleston Southern,31,10,21,0.323,6225,819,1850,568,1119,251,731,362,498,360,731,1091,373,157,81,365,562,2251,0.443,0.508,0.343,0.727,0.539,0.511
1554,2021-22,Charleston Southern,31,6,25,0.194,6225,745,1828,489,998,256,830,376,556,325,796,1121,371,203,93,454,502,2122,0.408,0.49,0.308,0.676,0.507,0.478
1555,2020-21,Charleston Southern,21,3,18,0.143,4225,480,1182,320,676,160,506,255,357,214,564,778,218,129,81,346,385,1375,0.406,0.473,0.316,0.714,0.509,0.474
1556,2019-20,Charleston Southern,32,14,18,0.438,6475,792,1856,534,1061,258,795,361,487,260,769,1029,424,190,82,404,493,2203,0.427,0.503,0.325,0.741,0.528,0.496
1557,2023-24,Central Michigan,32,18,14,0.563,6575,790,1880,590,1220,200,660,347,526,339,823,1162,364,192,119,384,527,2127,0.42,0.484,0.303,0.66,0.499,0.473
1558,2022-23,Central Michigan,31,10,21,0.323,6225,702,1688,511,1051,191,637,443,642,343,753,1096,333,181,118,494,614,2038,0.416,0.486,0.3,0.69,0.511,0.472
1559,2021-22,Central Michigan,30,7,23,0.233,6025,694,1696,462,1016,232,680,358,517,276,720,996,345,188,91,407,597,1978,0.409,0.455,0.341,0.692,0.509,0.478
1560,2020-21,Central Michigan,23,7,16,0.304,4600,631,1417,479,955,152,462,352,523,241,592,833,246,188,67,307,396,1766,0.445,0.502,0.329,0.673,0.53,0.499
1561,2019-20,Central Michigan,32,14,18,0.438,6425,876,2037,629,1274,247,763,507,680,349,804,1153,371,292,80,406,522,2506,0.43,0.494,0.324,0.746,0.531,0.491
1562,2023-24,Central Connecticut State,31,20,11,0.645,6250,810,1798,602,1153,208,645,409,577,298,813,1111,444,232,150,349,423,2237,0.451,0.522,0.322,0.709,0.54,0.508
1563,2022-23,Central Connecticut State,32,10,22,0.313,6475,791,1874,572,1205,219,669,310,437,324,768,1092,412,179,122,380,451,2111,0.422,0.475,0.327,0.709,0.507,0.481
1564,2021-22,Central Connecticut State,32,8,24,0.25,6475,690,1755,455,1067,235,688,362,511,296,724,1020,340,199,70,441,515,1977,0.393,0.426,0.342,0.708,0.495,0.46
1565,2020-21,Central Connecticut State,21,5,16,0.238,4200,522,1230,372,767,150,463,245,348,179,485,664,270,145,54,298,359,1439,0.424,0.485,0.324,0.704,0.516,0.485
1566,2019-20,Central Connecticut State,31,4,27,0.129,6200,705,1772,505,1212,200,560,349,516,263,726,989,313,199,105,440,581,1959,0.398,0.417,0.357,0.676,0.486,0.454
1567,2023-24,Central Arkansas,32,9,23,0.281,6425,817,1965,561,1218,256,747,419,566,359,806,1165,437,225,105,407,548,2309,0.416,0.461,0.343,0.74,0.517,0.481
1568,2022-23,Central Arkansas,31,9,22,0.29,6275,818,1987,554,1169,264,818,361,482,347,781,1128,384,202,98,413,508,2261,0.412,0.474,0.323,0.749,0.51,0.478
1569,2021-22,Central Arkansas,31,11,20,0.355,6250,862,1960,655,1271,207,689,338,444,313,786,1099,444,211,99,424,518,2269,0.44,0.515,0.3,0.761,0.523,0.493
1570,2020-21,Central Arkansas,24,5,19,0.208,4800,606,1388,436,920,170,468,319,445,246,643,889,322,121,64,419,433,1701,0.437,0.474,0.363,0.717,0.532,0.498
1571,2019-20,Central Arkansas,31,10,21,0.323,6350,777,1842,546,1097,231,745,531,741,329,857,1186,451,164,159,549,637,2316,0.422,0.498,0.31,0.717,0.528,0.485
1572,2023-24,Canisius,32,14,18,0.438,6450,841,1910,609,1220,232,690,338,541,384,797,1181,401,192,111,432,520,2252,0.44,0.499,0.336,0.625,0.52,0.501
1573,2022-23,Canisius,30,10,20,0.333,6125,763,1809,508,1075,255,734,328,448,313,695,1008,431,168,79,357,469,2111,0.422,0.473,0.347,0.732,0.522,0.492
1574,2021-22,Canisius,32,11,21,0.344,6450,777,1942,541,1171,236,771,402,580,355,778,1133,416,193,83,378,550,2192,0.4,0.462,0.306,0.693,0.494,0.461
1575,2020-21,Canisius,13,7,6,0.538,2600,321,786,224,459,97,327,176,248,130,320,450,165,73,45,156,234,915,0.408,0.488,0.297,0.71,0.506,0.47
1576,2019-20,Canisius,32,12,20,0.375,6400,806,1861,613,1222,193,639,391,562,328,743,1071,452,227,80,458,603,2196,0.433,0.502,0.302,0.696,0.516,0.485
1577,2023-24,Campbell,32,14,18,0.438,6475,806,1740,574,1067,232,673,428,590,246,794,1040,425,202,77,383,485,2272,0.463,0.538,0.345,0.725,0.562,0.53
1578,2022-23,Campbell,34,16,18,0.471,6925,830,1777,602,1094,228,683,486,691,267,799,1066,416,212,97,404,554,2374,0.467,0.55,0.334,0.703,0.564,0.531
1579,2021-22,Campbell,29,16,13,0.552,5850,721,1567,537,989,184,578,293,431,201,723,924,404,180,66,303,401,1919,0.46,0.543,0.318,0.68,0.542,0.519
1580,2020-21,Campbell,27,17,10,0.63,5475,699,1409,504,889,195,520,324,478,165,602,767,387,165,61,327,459,1917,0.496,0.567,0.375,0.678,0.586,0.565
1581,2019-20,Campbell,31,15,16,0.484,6225,781,1700,534,994,247,706,321,439,217,732,949,462,223,91,398,545,2130,0.459,0.537,0.35,0.731,0.558,0.532
1582,2023-24,California Baptist,33,16,17,0.485,6650,762,1857,542,1183,220,674,478,700,397,844,1241,372,133,87,392,524,2222,0.41,0.458,0.326,0.683,0.507,0.47
1583,2022-23,California Baptist,33,17,16,0.515,6650,811,1898,535,1061,276,837,393,592,362,865,1227,471,146,103,379,569,2291,0.427,0.504,0.33,0.664,0.526,0.5
1584,2021-22,California Baptist,34,18,16,0.529,6825,831,1900,559,1083,272,817,468,695,340,920,1260,541,176,93,473,626,2402,0.437,0.516,0.333,0.673,0.539,0.509
1585,2020-21,California Baptist,23,13,10,0.565,4625,634,1334,419,787,215,547,337,457,221,632,853,403,116,57,310,454,1820,0.475,0.532,0.393,0.737,0.587,0.556
1586,2019-20,California Baptist,31,21,10,0.677,6275,826,1868,520,1062,306,806,507,645,360,910,1270,445,129,108,396,571,2465,0.442,0.49,0.38,0.786,0.567,0.524
1587,2023-24,California,32,13,19,0.406,6550,833,1980,552,1149,281,831,420,578,343,846,1189,387,193,83,370,552,2367,0.421,0.48,0.338,0.727,0.525,0.492
1588,2022-23,California,32,3,29,0.094,6450,662,1694,506,1170,156,524,386,534,278,729,1007,308,151,100,417,548,1866,0.391,0.432,0.298,0.723,0.479,0.437
1589,2021-22,California,32,12,20,0.375,6450,756,1798,581,1229,175,569,331,455,279,842,1121,342,156,83,359,529,2018,0.42,0.473,0.308,0.727,0.501,0.469
1590,2020-21,California,29,9,20,0.31,5800,661,1536,457,914,204,622,371,532,235,682,917,346,126,65,370,516,1897,0.43,0.5,0.328,0.697,0.53,0.497
1591,2019-20,California,32,14,18,0.438,6475,708,1681,548,1204,160,477,447,606,258,786,1044,294,129,80,409,601,2023,0.421,0.455,0.335,0.738,0.514,0.469
1592,2023-24,Cal State Northridge,34,19,15,0.559,6825,940,2065,775,1528,165,537,506,757,402,960,1362,472,253,114,481,707,2551,0.455,0.507,0.307,0.668,0.526,0.495
1593,2022-23,Cal State Northridge,32,7,25,0.219,6425,695,1735,511,1160,184,575,454,612,313,753,1066,314,201,99,400,605,2028,0.401,0.441,0.32,0.742,0.501,0.454
1594,2021-22,Cal State Northridge,30,7,23,0.233,6075,678,1684,524,1176,154,508,337,494,295,657,952,275,216,76,368,560,1847,0.403,0.446,0.303,0.682,0.481,0.448
1595,2020-21,Cal State Northridge,22,9,13,0.409,4425,560,1323,390,820,170,503,296,407,208,522,730,293,140,47,261,383,1586,0.423,0.476,0.338,0.727,0.523,0.488
1596,2019-20,Cal State Northridge,32,15,17,0.469,6400,877,1925,634,1273,243,652,438,603,290,778,1068,449,181,101,363,554,2435,0.456,0.498,0.373,0.726,0.551,0.519
1597,2023-24,Cal State Fullerton,32,14,18,0.438,6425,740,1717,533,1090,207,627,485,685,269,779,1048,284,214,98,393,571,2172,0.431,0.489,0.33,0.708,0.532,0.491
1598,2022-23,Cal State Fullerton,33,20,13,0.606,6799,779,1812,526,1126,253,686,472,681,303,805,1108,340,214,85,391,590,2283,0.43,0.467,0.369,0.693,0.535,0.5
1599,2021-22,Cal State Fullerton,32,21,11,0.656,6400,792,1781,616,1246,176,535,479,625,312,758,1070,360,233,63,388,506,2239,0.445,0.494,0.329,0.766,0.539,0.494
1600,2020-21,Cal State Fullerton,16,6,10,0.375,3225,430,951,299,610,131,341,241,326,140,386,526,218,107,32,205,271,1232,0.452,0.49,0.384,0.739,0.557,0.521
1601,2019-20,Cal State Fullerton,31,11,20,0.355,6325,750,1735,556,1149,194,586,433,644,250,790,1040,358,158,93,406,574,2127,0.432,0.484,0.331,0.672,0.521,0.488
1602,2023-24,Cal State Bakersfield,32,13,19,0.406,6475,807,1861,657,1385,150,476,435,602,382,727,1109,335,220,114,389,652,2199,0.434,0.474,0.315,0.723,0.512,0.474
1603,2022-23,Cal State Bakersfield,33,11,22,0.333,6700,732,1770,590,1333,142,437,389,512,311,744,1055,355,205,100,424,621,1995,0.414,0.443,0.325,0.76,0.495,0.454
1604,2021-22,Cal State Bakersfield,28,9,19,0.321,5600,682,1613,575,1241,107,372,345,489,334,647,981,279,173,67,327,577,1816,0.423,0.463,0.288,0.706,0.492,0.456
1605,2020-21,Cal State Bakersfield,26,15,11,0.577,5225,684,1531,538,1117,146,414,297,416,348,611,959,365,167,78,338,499,1811,0.447,0.482,0.353,0.714,0.524,0.494
1606,2019-20,Cal State Bakersfield,31,12,19,0.387,6325,785,1803,631,1312,154,491,385,563,398,757,1155,363,194,94,422,662,2109,0.435,0.481,0.314,0.684,0.509,0.478
1607,2023-24,Cal Poly,32,4,28,0.125,6475,719,1778,521,1180,198,598,401,569,283,717,1000,314,173,117,405,614,2037,0.404,0.442,0.331,0.705,0.497,0.46
1608,2022-23,Cal Poly,33,8,25,0.242,6650,715,1733,534,1118,181,615,395,531,281,799,1080,341,181,82,457,653,2006,0.413,0.478,0.294,0.744,0.505,0.465
1609,2021-22,Cal Poly,28,7,21,0.25,5675,593,1450,446,943,147,507,388,533,259,720,979,295,132,68,412,543,1721,0.409,0.473,0.29,0.728,0.505,0.46
1610,2020-21,Cal Poly,24,4,20,0.167,4825,519,1315,362,824,157,491,280,388,187,591,778,298,149,84,333,447,1475,0.395,0.439,0.32,0.722,0.492,0.454
1611,2019-20,Cal Poly,30,7,23,0.233,6175,710,1685,510,1112,200,573,407,587,244,733,977,312,192,74,409,629,2027,0.421,0.459,0.349,0.693,0.516,0.481
1612,2023-24,Butler,33,18,15,0.545,6750,922,2036,646,1258,276,778,424,536,308,854,1162,499,204,110,361,454,2544,0.453,0.514,0.355,0.791,0.555,0.521
1613,2022-23,Butler,32,14,18,0.438,6400,771,1767,564,1134,207,633,339,459,207,751,958,403,216,138,378,429,2088,0.436,0.497,0.327,0.739,0.526,0.495
1614,2021-22,Butler,33,14,19,0.424,6675,749,1799,520,1048,229,751,380,546,298,785,1083,363,171,80,395,550,2107,0.416,0.496,0.305,0.696,0.512,0.48
1615,2020-21,Butler,25,10,15,0.4,5075,572,1393,393,839,179,554,265,410,230,577,807,308,139,51,286,406,1588,0.411,0.468,0.323,0.646,0.5,0.475
1616,2019-20,Butler,31,22,9,0.71,6225,776,1687,564,1066,212,621,361,496,280,799,1079,395,165,82,349,519,2125,0.46,0.529,0.341,0.728,0.553,0.523
1617,2023-24,Buffalo,31,4,27,0.129,6225,770,1830,563,1084,207,746,361,504,323,759,1082,415,188,141,450,484,2108,0.421,0.519,0.277,0.716,0.509,0.477
1618,2022-23,Buffalo,32,15,17,0.469,6425,906,2000,682,1304,224,696,445,632,377,831,1208,470,254,102,452,602,2481,0.453,0.523,0.322,0.704,0.539,0.509
1619,2021-22,Buffalo,30,19,11,0.633,6000,891,1957,636,1211,255,746,361,509,425,848,1273,451,214,137,396,513,2398,0.455,0.525,0.342,0.709,0.545,0.52
1620,2020-21,Buffalo,25,16,9,0.64,5050,766,1662,591,1144,175,518,327,487,370,724,1094,397,199,103,347,442,2034,0.461,0.517,0.338,0.671,0.537,0.514
1621,2019-20,Buffalo,32,20,12,0.625,6450,927,2139,666,1330,261,809,401,598,463,880,1343,473,249,147,437,600,2516,0.433,0.501,0.323,0.671,0.519,0.494
1622,2023-24,Bucknell,33,14,19,0.424,6675,758,1770,489,975,269,795,368,514,276,797,1073,399,202,113,405,559,2153,0.428,0.502,0.338,0.716,0.534,0.504
1623,2022-23,Bucknell,32,12,20,0.375,6450,797,1749,562,1089,235,660,332,463,260,824,1084,429,176,121,427,498,2161,0.456,0.516,0.356,0.717,0.549,0.523
1624,2021-22,Bucknell,32,9,23,0.281,6550,818,1790,565,1117,253,673,388,507,218,796,1014,471,148,100,431,490,2277,0.457,0.506,0.376,0.765,0.561,0.528
1625,2020-21,Bucknell,12,5,7,0.417,2400,311,683,223,416,88,267,189,248,78,324,402,144,70,42,152,209,899,0.455,0.536,0.33,0.762,0.561,0.52
1626,2019-20,Bucknell,34,14,20,0.412,6800,820,1945,541,1132,279,813,380,553,286,815,1101,410,243,117,451,632,2299,0.422,0.478,0.343,0.687,0.521,0.493
1627,2023-24,Bryant,33,20,13,0.606,6650,954,2087,681,1281,273,806,417,623,259,987,1246,487,230,213,393,557,2598,0.457,0.532,0.339,0.669,0.545,0.523
1628,2022-23,Bryant,30,17,13,0.567,6025,848,1821,605,1107,243,714,442,602,318,861,1179,403,200,106,402,518,2381,0.466,0.547,0.34,0.734,0.565,0.532
1629,2021-22,Bryant,32,22,10,0.688,6450,879,2013,615,1145,264,868,475,649,404,918,1322,444,207,143,444,544,2497,0.437,0.537,0.304,0.732,0.538,0.502
1630,2020-21,Bryant,22,15,7,0.682,4400,638,1372,430,826,208,546,359,472,224,652,876,336,152,78,333,365,1843,0.465,0.521,0.381,0.761,0.577,0.541
1631,2019-20,Bryant,32,15,17,0.469,6425,802,1932,533,1095,269,837,398,588,389,900,1289,441,207,140,460,588,2271,0.415,0.487,0.321,0.677,0.513,0.485
1632,2023-24,Brown,31,13,18,0.419,6307,782,1818,528,1073,254,745,394,603,367,787,1154,417,196,131,385,519,2212,0.43,0.492,0.341,0.653,0.526,0.5
1633,2022-23,Brown,27,14,13,0.519,5428,682,1557,466,935,216,622,298,464,241,701,942,372,194,87,361,438,1878,0.438,0.498,0.347,0.642,0.528,0.507
1634,2021-22,Brown,29,13,16,0.448,5800,739,1698,530,1030,209,668,371,523,304,725,1029,354,194,112,381,520,2058,0.435,0.515,0.313,0.709,0.529,0.497
1635,2019-20,Brown,27,15,12,0.556,5400,626,1576,443,976,183,600,374,512,332,701,1033,304,179,118,405,451,1809,0.397,0.454,0.305,0.73,0.497,0.455
1636,2023-24,Brigham Young,34,23,11,0.676,6800,992,2155,614,1068,378,1087,406,547,405,938,1343,629,202,101,364,602,2768,0.46,0.575,0.348,0.742,0.573,0.548
1637,2022-23,Brigham Young,34,19,15,0.559,6825,913,2008,637,1196,276,812,466,650,374,898,1272,501,251,135,481,659,2568,0.455,0.533,0.34,0.717,0.554,0.523
1638,2021-22,Brigham Young,35,24,11,0.686,7050,960,2101,680,1308,280,793,399,556,374,1002,1376,513,168,111,441,619,2599,0.457,0.52,0.353,0.718,0.549,0.524
1639,2020-21,Brigham Young,27,20,7,0.741,5475,776,1608,540,975,236,633,321,443,255,803,1058,436,124,76,356,486,2109,0.483,0.554,0.373,0.725,0.58,0.556
1640,2019-20,Brigham Young,32,24,8,0.75,6475,949,1897,617,1112,332,785,318,454,209,852,1061,554,186,67,353,513,2548,0.5,0.555,0.423,0.7,0.603,0.588
1641,2023-24,Bradley,35,23,12,0.657,7075,943,1999,637,1164,306,835,400,550,324,890,1214,463,250,144,423,578,2592,0.472,0.547,0.366,0.727,0.573,0.548
1642,2022-23,Bradley,35,25,10,0.714,7025,917,1989,641,1212,276,777,363,546,341,899,1240,465,238,136,409,565,2473,0.461,0.529,0.355,0.665,0.55,0.53
1643,2021-22,Bradley,31,17,14,0.548,6225,799,1800,558,1086,241,714,346,502,346,856,1202,419,197,142,420,527,2185,0.444,0.514,0.338,0.689,0.536,0.511
1644,2020-21,Bradley,28,12,16,0.429,5650,736,1636,544,1033,192,603,284,393,284,749,1033,382,144,100,346,455,1948,0.45,0.527,0.318,0.723,0.534,0.509
1645,2019-20,Bradley,34,23,11,0.676,6850,872,1976,642,1358,230,618,464,631,377,933,1310,457,163,138,400,562,2438,0.441,0.473,0.372,0.735,0.536,0.499
1646,2023-24,Bowling Green,34,20,14,0.588,6925,882,2045,666,1315,216,730,522,730,386,906,1292,383,221,96,392,533,2502,0.431,0.506,0.296,0.715,0.523,0.484
1647,2022-23,Bowling Green,31,11,20,0.355,6200,840,1859,616,1201,224,658,451,622,326,783,1109,428,188,93,378,550,2355,0.452,0.513,0.34,0.725,0.547,0.512
1648,2021-22,Bowling Green,31,13,18,0.419,6250,881,2024,626,1273,255,751,471,637,376,826,1202,390,227,106,381,550,2488,0.435,0.492,0.34,0.739,0.535,0.498
1649,2020-21,Bowling Green,26,14,12,0.538,5250,724,1732,511,1065,213,667,354,481,325,671,996,328,184,57,256,442,2015,0.418,0.48,0.319,0.736,0.514,0.48
1650,2019-20,Bowling Green,31,21,10,0.677,6250,822,1968,580,1251,242,717,424,564,349,889,1238,380,169,71,343,545,2310,0.418,0.464,0.338,0.752,0.517,0.479
1651,2023-24,Boston University,33,16,17,0.485,6675,768,1856,514,1093,254,763,403,562,309,858,1167,427,216,102,384,571,2193,0.414,0.47,0.333,0.717,0.516,0.482
1652,2022-23,Boston University,32,15,17,0.469,6500,761,1845,523,1123,238,722,387,524,328,808,1136,335,205,79,384,561,2147,0.412,0.466,0.33,0.739,0.513,0.477
1653,2021-22,Boston University,35,22,13,0.629,7075,893,1967,630,1224,263,743,421,570,356,862,1218,384,197,85,424,545,2470,0.454,0.515,0.354,0.739,0.552,0.521
1654,2020-21,Boston University,18,7,11,0.389,3600,451,1035,326,642,125,393,222,296,181,455,636,190,97,56,225,305,1249,0.436,0.508,0.318,0.75,0.531,0.496
1655,2019-20,Boston University,34,21,13,0.618,6875,919,1998,695,1311,224,687,348,540,343,885,1228,430,187,77,384,513,2410,0.46,0.53,0.326,0.644,0.534,0.516
1656,2023-24,Boston College,36,20,16,0.556,7250,982,2155,683,1329,299,826,404,539,338,933,1271,509,212,124,376,566,2667,0.456,0.514,0.362,0.75,0.553,0.525
1657,2022-23,Boston College,33,16,17,0.485,6650,819,1873,631,1283,188,590,371,512,308,785,1093,413,210,118,405,521,2197,0.437,0.492,0.319,0.725,0.519,0.487
1658,2021-22,Boston College,33,13,20,0.394,6700,812,1897,622,1283,190,614,395,561,352,778,1130,408,237,97,393,514,2209,0.428,0.485,0.309,0.704,0.511,0.478
1659,2020-21,Boston College,20,4,16,0.2,4025,500,1185,320,639,180,546,247,352,183,482,665,230,144,77,274,324,1427,0.422,0.501,0.33,0.702,0.528,0.498
1660,2019-20,Boston College,32,13,19,0.406,6425,742,1844,512,1097,230,747,353,536,301,757,1058,403,245,82,439,506,2067,0.402,0.467,0.308,0.659,0.492,0.465
1661,2023-24,Boise State,33,22,11,0.667,6650,858,1913,600,1154,258,759,505,686,384,847,1231,404,189,78,366,550,2479,0.449,0.52,0.34,0.736,0.554,0.516
1662,2022-23,Boise State,34,24,10,0.706,6875,878,1938,613,1205,265,733,430,587,307,908,1215,385,171,97,379,555,2451,0.453,0.509,0.362,0.733,0.553,0.521
1663,2021-22,Boise State,35,27,8,0.771,7075,849,1910,592,1168,257,742,434,668,358,861,1219,399,210,120,422,526,2389,0.445,0.507,0.346,0.65,0.536,0.512
1664,2020-21,Boise State,28,19,9,0.679,5625,743,1634,523,999,220,635,416,566,253,742,995,378,183,80,328,478,2122,0.455,0.524,0.346,0.735,0.558,0.522
1665,2019-20,Boise State,32,20,12,0.625,6525,829,1853,560,1072,269,781,503,670,285,828,1113,416,182,46,399,551,2430,0.447,0.522,0.344,0.751,0.56,0.52
1666,2023-24,Binghamton,30,15,15,0.5,6050,801,1738,637,1202,164,536,397,595,313,843,1156,435,150,113,366,498,2163,0.461,0.53,0.306,0.667,0.535,0.508
1667,2022-23,Binghamton,31,13,18,0.419,6300,794,1763,622,1230,172,533,373,523,301,785,1086,361,144,98,404,558,2133,0.45,0.506,0.323,0.713,0.53,0.499
1668,2021-22,Binghamton,29,12,17,0.414,5825,746,1692,533,1090,213,602,257,389,276,769,1045,334,164,106,366,484,1962,0.441,0.489,0.354,0.661,0.523,0.504
1669,2020-21,Binghamton,18,4,14,0.222,3675,430,1039,274,567,156,472,162,241,191,451,642,199,90,55,250,307,1178,0.414,0.483,0.331,0.672,0.511,0.489
1670,2019-20,Binghamton,29,10,19,0.345,5825,717,1750,439,911,278,839,302,417,278,735,1013,339,151,88,358,479,2014,0.41,0.482,0.331,0.724,0.517,0.489
1671,2023-24,Bethune-Cookman,34,17,17,0.5,6875,860,1994,661,1374,199,620,560,742,356,783,1139,414,351,117,471,696,2479,0.431,0.481,0.321,0.755,0.528,0.481
1672,2022-23,Bethune-Cookman,32,12,20,0.375,6425,772,1863,553,1257,219,606,409,586,321,717,1038,362,231,90,413,555,2172,0.414,0.44,0.361,0.698,0.507,0.473
1673,2021-22,Bethune-Cookman,30,9,21,0.3,6050,710,1705,566,1276,144,429,337,489,300,677,977,322,238,73,401,514,1901,0.416,0.444,0.336,0.689,0.491,0.459
1674,2019-20,Bethune-Cookman,30,16,14,0.533,6075,782,1842,598,1266,184,576,491,701,354,821,1175,362,217,89,465,591,2239,0.425,0.472,0.319,0.7,0.515,0.474
1675,2023-24,Belmont,33,20,13,0.606,6626,922,1939,621,1128,301,811,425,588,237,893,1130,504,248,101,402,511,2570,0.476,0.551,0.371,0.723,0.579,0.553
1676,2022-23,Belmont,32,21,11,0.656,6450,898,1902,591,1111,307,791,344,474,267,788,1055,488,225,101,365,499,2447,0.472,0.532,0.388,0.726,0.575,0.553
1677,2021-22,Belmont,33,25,8,0.758,6650,957,1960,675,1110,282,850,387,521,256,848,1104,595,299,129,390,452,2583,0.488,0.608,0.332,0.743,0.585,0.56
1678,2020-21,Belmont,30,26,4,0.867,6025,894,1829,623,1042,271,787,380,515,264,808,1072,547,232,87,361,438,2439,0.489,0.598,0.344,0.738,0.588,0.563
1679,2019-20,Belmont,33,26,7,0.788,6600,986,2074,666,1166,320,908,335,470,290,942,1232,604,249,106,392,497,2627,0.475,0.571,0.352,0.713,0.572,0.553
1680,2023-24,Bellarmine,31,8,23,0.258,6250,797,1837,559,1139,238,698,321,412,245,757,1002,420,164,60,297,486,2153,0.434,0.491,0.341,0.779,0.53,0.499
1681,2022-23,Bellarmine,33,15,18,0.455,6650,797,1738,533,986,264,752,329,436,217,743,960,467,184,45,368,522,2187,0.459,0.541,0.351,0.755,0.562,0.535
1682,2021-22,Bellarmine,33,20,13,0.606,6625,878,1847,621,1092,257,755,301,400,240,761,1001,478,185,55,312,473,2314,0.475,0.569,0.34,0.753,0.568,0.545
1683,2020-21,Bellarmine,22,14,8,0.636,4400,615,1211,472,830,143,381,261,345,171,496,667,342,160,50,245,342,1634,0.508,0.569,0.375,0.757,0.594,0.567
1684,2023-24,Baylor,35,24,11,0.686,7150,967,2001,666,1228,301,773,579,791,399,830,1229,514,236,110,421,577,2814,0.483,0.542,0.389,0.732,0.592,0.558
1685,2022-23,Baylor,34,23,11,0.676,6825,880,1957,557,1079,323,878,536,720,391,764,1155,483,223,82,413,590,2619,0.45,0.516,0.368,0.744,0.57,0.532
1686,2021-22,Baylor,34,27,7,0.794,6850,962,2083,688,1284,274,799,421,604,437,827,1264,542,298,117,421,548,2619,0.462,0.536,0.343,0.697,0.553,0.528
1687,2020-21,Baylor,30,28,2,0.933,6025,917,1886,618,1162,299,724,354,500,374,705,1079,507,267,111,345,513,2487,0.486,0.532,0.413,0.708,0.586,0.565
1688,2019-20,Baylor,30,26,4,0.867,6025,763,1778,533,1122,230,656,378,548,387,719,1106,413,244,132,357,509,2134,0.429,0.475,0.351,0.69,0.523,0.494
1689,2023-24,Ball State,31,15,16,0.484,6275,769,1726,537,1085,232,641,510,665,294,788,1082,385,170,96,374,469,2280,0.446,0.495,0.362,0.767,0.558,0.513
1690,2022-23,Ball State,32,20,12,0.625,6425,841,1785,601,1134,240,651,523,759,337,810,1147,422,176,123,391,525,2445,0.471,0.53,0.369,0.689,0.57,0.538
1691,2021-22,Ball State,31,14,17,0.452,6225,788,1783,523,1048,265,735,463,667,301,804,1105,408,188,75,433,555,2304,0.442,0.499,0.361,0.694,0.549,0.516
1692,2020-21,Ball State,23,10,13,0.435,4650,613,1384,418,814,195,570,298,397,229,619,848,318,126,55,330,441,1719,0.443,0.514,0.342,0.751,0.547,0.513
1693,2019-20,Ball State,31,18,13,0.581,6200,749,1754,466,912,283,842,374,540,272,847,1119,417,206,105,413,496,2155,0.427,0.511,0.336,0.693,0.536,0.508
1694,2023-24,Austin Peay,35,19,16,0.543,7125,941,2105,664,1337,277,768,460,652,378,810,1188,388,250,95,308,615,2619,0.447,0.497,0.361,0.706,0.542,0.513
1695,2022-23,Austin Peay,31,9,22,0.29,6224,743,1790,521,1100,222,690,359,495,312,660,972,387,220,94,364,525,2067,0.415,0.474,0.322,0.725,0.51,0.477
1696,2021-22,Austin Peay,29,12,17,0.414,5875,669,1639,440,913,229,726,308,436,306,646,952,392,186,59,405,483,1875,0.408,0.482,0.315,0.706,0.508,0.478
1697,2020-21,Austin Peay,27,14,13,0.519,5450,733,1617,539,1044,194,573,347,462,341,590,931,357,183,54,397,472,2007,0.453,0.516,0.339,0.751,0.546,0.513
1698,2019-20,Austin Peay,33,21,12,0.636,6625,892,1943,669,1299,223,644,512,715,390,799,1189,434,218,100,423,604,2519,0.459,0.515,0.346,0.716,0.552,0.516
1699,2023-24,Auburn,35,27,8,0.771,7000,1010,2121,730,1326,280,795,609,812,393,930,1323,622,258,215,374,678,2909,0.476,0.551,0.352,0.75,0.58,0.542
1700,2022-23,Auburn,34,21,13,0.618,6825,875,1991,654,1290,221,701,503,723,396,835,1231,479,263,172,414,655,2474,0.439,0.507,0.315,0.696,0.53,0.495
1701,2021-22,Auburn,34,28,6,0.824,6900,943,2166,669,1304,274,862,500,684,435,940,1375,501,284,272,411,629,2660,0.435,0.513,0.318,0.731,0.534,0.499
1702,2020-21,Auburn,27,13,14,0.481,5450,711,1628,466,877,245,751,417,589,348,715,1063,400,168,163,438,482,2084,0.437,0.531,0.326,0.708,0.546,0.512
1703,2019-20,Auburn,31,25,6,0.806,6350,808,1868,556,1044,252,824,551,818,421,845,1266,397,199,151,399,596,2419,0.433,0.533,0.306,0.674,0.536,0.5
1704,2023-24,Army,32,10,22,0.313,6475,707,1747,455,959,252,788,264,449,308,780,1088,401,184,126,389,506,1930,0.405,0.474,0.32,0.588,0.492,0.477
1705,2022-23,Army,33,17,16,0.515,6650,885,1853,633,1135,252,718,390,570,280,852,1132,432,168,70,427,532,2412,0.478,0.558,0.351,0.684,0.568,0.546
1706,2021-22,Army,31,15,16,0.484,6250,804,1839,595,1187,209,652,366,581,344,810,1154,389,243,58,408,460,2183,0.437,0.501,0.321,0.63,0.516,0.494
1707,2020-21,Army,22,12,10,0.545,4425,587,1286,415,759,172,527,232,364,178,583,761,316,138,32,275,342,1578,0.456,0.547,0.326,0.637,0.541,0.523
1708,2019-20,Army,30,15,15,0.5,6050,821,1742,606,1097,215,645,271,441,201,815,1016,487,167,49,354,444,2128,0.471,0.552,0.333,0.615,0.545,0.533
1709,2023-24,Arkansas–Pine Bluff,31,13,18,0.419,6200,813,1821,476,923,337,898,520,682,261,812,1073,467,183,67,413,568,2483,0.446,0.516,0.375,0.762,0.579,0.539
1710,2022-23,Arkansas–Pine Bluff,31,10,21,0.323,6250,701,1791,456,1015,245,776,427,587,314,757,1071,396,250,86,473,611,2074,0.391,0.449,0.316,0.727,0.501,0.46
1711,2021-22,Arkansas–Pine Bluff,31,7,24,0.226,6225,708,1732,496,1027,212,705,427,597,272,642,914,355,222,80,406,540,2055,0.409,0.483,0.301,0.715,0.51,0.47
1712,2020-21,Arkansas–Pine Bluff,25,4,21,0.16,5050,524,1356,401,956,123,400,378,523,240,567,807,240,160,95,394,455,1549,0.386,0.419,0.308,0.723,0.483,0.432
1713,2019-20,Arkansas–Pine Bluff,30,4,26,0.133,6025,588,1483,475,1054,113,429,326,554,267,673,940,288,216,97,531,617,1615,0.396,0.451,0.263,0.588,0.462,0.435
1714,2023-24,Arkansas State,37,20,17,0.541,7425,1021,2313,680,1322,341,991,534,761,489,930,1419,536,207,163,414,644,2917,0.441,0.514,0.344,0.702,0.545,0.515
1715,2022-23,Arkansas State,33,13,20,0.394,6625,777,1799,568,1206,209,593,406,600,325,783,1108,433,220,108,385,553,2169,0.432,0.471,0.352,0.677,0.52,0.49
1716,2021-22,Arkansas State,29,18,11,0.621,5825,745,1653,588,1148,157,505,408,548,294,750,1044,452,229,96,403,482,2055,0.451,0.512,0.311,0.745,0.537,0.498
1717,2020-21,Arkansas State,24,11,13,0.458,4825,621,1390,467,988,154,402,345,478,265,627,892,347,158,68,313,385,1741,0.447,0.473,0.383,0.722,0.538,0.502
1718,2019-20,Arkansas State,32,16,16,0.5,6450,750,1718,566,1173,184,545,578,814,316,738,1054,442,220,85,415,655,2262,0.437,0.483,0.338,0.71,0.537,0.49
1719,2023-24,Arkansas,33,16,17,0.485,6700,859,1898,660,1273,199,625,649,859,281,858,1139,387,198,201,395,655,2566,0.453,0.518,0.318,0.756,0.556,0.505
1720,2022-23,Arkansas,36,22,14,0.611,7225,961,2063,782,1491,179,572,565,810,373,899,1272,462,302,182,458,694,2666,0.466,0.524,0.313,0.698,0.545,0.509
1721,2021-22,Arkansas,37,28,9,0.757,7450,972,2241,739,1474,233,767,633,833,399,1000,1399,512,281,153,452,624,2810,0.434,0.501,0.304,0.76,0.533,0.486
1722,2020-21,Arkansas,32,25,7,0.781,6425,935,2071,702,1369,233,702,501,677,378,893,1271,466,251,158,412,540,2604,0.451,0.513,0.332,0.74,0.544,0.508
1723,2019-20,Arkansas,32,20,12,0.625,6500,808,1825,565,1097,243,728,567,776,239,771,1010,381,253,124,369,638,2426,0.443,0.515,0.334,0.731,0.553,0.509
1724,2023-24,Arizona State,32,14,18,0.438,6425,791,1901,576,1185,215,716,412,629,269,795,1064,385,263,117,335,532,2209,0.416,0.486,0.3,0.655,0.502,0.473
1725,2022-23,Arizona State,36,23,13,0.639,7275,910,2163,636,1312,274,851,465,675,395,920,1315,515,255,170,422,668,2559,0.421,0.485,0.322,0.689,0.515,0.484
1726,2021-22,Arizona State,31,14,17,0.452,6300,775,1873,561,1176,214,697,263,398,292,810,1102,414,207,131,370,562,2027,0.414,0.477,0.307,0.661,0.492,0.471
1727,2020-21,Arizona State,25,11,14,0.44,5050,656,1515,477,978,179,537,367,504,196,601,797,327,182,82,274,478,1858,0.433,0.488,0.333,0.728,0.53,0.492
1728,2019-20,Arizona State,31,20,11,0.645,6200,816,1904,589,1201,227,703,429,617,312,803,1115,345,249,104,408,577,2288,0.429,0.49,0.323,0.695,0.521,0.488
1729,2023-24,Arizona,36,27,9,0.75,7325,1124,2321,840,1545,284,776,605,844,471,1062,1533,665,300,133,430,590,3137,0.484,0.544,0.366,0.717,0.576,0.545
1730,2022-23,Arizona,35,28,7,0.8,7000,1023,2072,728,1291,295,781,525,742,356,1020,1376,662,213,110,468,593,2866,0.494,0.564,0.378,0.708,0.591,0.565
1731,2021-22,Arizona,37,33,4,0.892,7450,1117,2269,830,1454,287,815,586,793,429,1102,1531,726,249,210,497,619,3107,0.492,0.571,0.352,0.739,0.587,0.556
1732,2020-21,Arizona,26,17,9,0.654,5250,667,1492,493,1024,174,468,453,623,305,692,997,403,152,104,309,463,1961,0.447,0.481,0.372,0.727,0.548,0.505
1733,2019-20,Arizona,32,21,11,0.656,6450,850,1905,617,1244,233,661,512,699,349,849,1198,492,216,119,378,593,2445,0.446,0.496,0.352,0.732,0.546,0.507
1734,2023-24,Appalachian State,34,27,7,0.794,6950,997,2100,773,1426,224,674,447,657,373,1043,1416,498,209,230,365,449,2665,0.475,0.542,0.332,0.68,0.552,0.528
1735,2022-23,Appalachian State,32,16,16,0.5,6449,819,1854,576,1128,243,726,367,543,288,854,1142,417,204,146,352,442,2248,0.442,0.511,0.335,0.676,0.532,0.507
1736,2021-22,Appalachian State,34,19,15,0.559,6825,822,1966,539,1120,283,846,354,537,335,864,1199,427,191,85,350,437,2281,0.418,0.481,0.335,0.659,0.513,0.49
1737,2020-21,Appalachian State,29,17,12,0.586,5925,690,1688,457,951,233,737,426,574,319,734,1053,344,230,107,343,394,2039,0.409,0.481,0.316,0.742,0.52,0.478
1738,2019-20,Appalachian State,33,18,15,0.545,6625,775,1800,563,1101,212,699,494,741,323,830,1153,381,246,74,440,514,2256,0.431,0.511,0.303,0.667,0.524,0.489
1739,2023-24,American,32,16,16,0.5,6453,782,1740,503,946,279,794,355,492,287,756,1043,449,186,54,347,527,2200,0.449,0.532,0.351,0.722,0.557,0.53
1740,2022-23,American,32,17,15,0.531,6500,785,1630,581,1041,204,589,319,455,259,711,970,436,238,126,448,482,2093,0.482,0.558,0.346,0.701,0.567,0.544
1741,2021-22,American,32,10,22,0.313,6450,781,1737,620,1250,161,487,308,444,223,758,981,390,209,98,427,477,2031,0.45,0.496,0.331,0.694,0.521,0.496
1742,2020-21,American,10,4,6,0.4,2100,248,557,158,319,90,238,105,149,78,248,326,128,73,47,158,193,691,0.445,0.495,0.378,0.705,0.55,0.526
1743,2019-20,American,30,16,14,0.533,6025,796,1743,590,1137,206,606,351,499,267,711,978,384,240,106,369,521,2149,0.457,0.519,0.34,0.703,0.543,0.516
1744,2023-24,Alcorn State,32,14,18,0.438,6425,818,1851,652,1359,166,492,498,699,360,726,1086,371,220,56,370,567,2300,0.442,0.48,0.337,0.712,0.527,0.487
1745,2022-23,Alcorn State,32,18,14,0.563,6505,763,1868,599,1314,164,554,475,659,384,703,1087,316,257,80,404,605,2165,0.408,0.456,0.296,0.721,0.496,0.452
1746,2021-22,Alcorn State,34,17,17,0.5,6850,817,1984,634,1404,183,580,445,643,400,820,1220,352,253,92,478,604,2262,0.412,0.452,0.316,0.692,0.494,0.458
1747,2020-21,Alcorn State,19,6,13,0.316,3800,435,1107,322,731,113,376,273,376,206,402,608,177,144,30,276,394,1256,0.393,0.44,0.301,0.726,0.488,0.444
1748,2019-20,Alcorn State,30,15,15,0.5,6050,784,1836,516,1103,268,733,415,558,330,786,1116,404,239,98,433,549,2251,0.427,0.468,0.366,0.744,0.536,0.5
1749,2023-24,Albany (NY),32,13,19,0.406,6425,918,2059,668,1302,250,757,431,594,364,789,1153,411,266,101,425,621,2517,0.446,0.513,0.33,0.726,0.538,0.507
1750,2022-23,Albany (NY),31,8,23,0.258,6227,726,1755,489,1030,237,725,397,550,317,716,1033,363,178,51,414,576,2086,0.414,0.475,0.327,0.722,0.517,0.481
1751,2021-22,Albany (NY),31,13,18,0.419,6225,714,1741,532,1178,182,563,307,436,281,711,992,292,209,76,383,558,1917,0.41,0.452,0.323,0.704,0.492,0.462
1752,2020-21,Albany (NY),16,7,9,0.438,3200,395,883,293,580,102,303,218,301,110,370,480,187,98,29,201,285,1110,0.447,0.505,0.337,0.724,0.541,0.505
1753,2019-20,Albany (NY),32,14,18,0.438,6425,725,1768,470,994,255,774,422,600,259,837,1096,409,179,90,436,533,2127,0.41,0.473,0.329,0.703,0.518,0.482
1754,2023-24,Alabama State,32,13,19,0.406,6514,772,2087,549,1294,223,793,428,592,453,812,1265,345,277,123,361,609,2195,0.37,0.424,0.281,0.723,0.463,0.423
1755,2022-23,Alabama State,31,8,23,0.258,6225,683,1821,498,1216,185,605,412,584,387,730,1117,309,182,110,414,557,1963,0.375,0.41,0.306,0.705,0.468,0.426
1756,2021-22,Alabama State,31,10,21,0.323,6250,751,1762,558,1181,193,581,465,666,326,736,1062,373,234,111,477,560,2160,0.426,0.472,0.332,0.698,0.52,0.481
1757,2020-21,Alabama State,18,4,14,0.222,3600,383,1009,272,659,111,350,279,431,205,448,653,175,110,43,291,343,1156,0.38,0.413,0.317,0.647,0.476,0.435
1758,2019-20,Alabama State,32,8,24,0.25,6400,683,1763,475,1076,208,687,391,629,295,736,1031,325,200,70,512,638,1965,0.387,0.441,0.303,0.622,0.477,0.446
1759,2023-24,Alabama A&M,35,12,23,0.343,7025,806,1918,658,1402,148,516,654,906,394,854,1248,369,261,136,565,727,2414,0.42,0.469,0.287,0.722,0.514,0.459
1760,2022-23,Alabama A&M,33,15,18,0.455,6678,823,1868,597,1258,226,610,425,649,334,745,1079,419,264,133,498,624,2297,0.441,0.475,0.37,0.655,0.528,0.501
1761,2021-22,Alabama A&M,30,12,18,0.4,6100,656,1733,539,1302,117,431,414,581,334,800,1134,285,211,96,407,483,1843,0.379,0.414,0.271,0.713,0.459,0.412
1762,2020-21,Alabama A&M,15,6,9,0.4,3050,347,868,264,582,83,286,173,276,160,417,577,164,82,54,229,272,950,0.4,0.454,0.29,0.627,0.475,0.448
1763,2019-20,Alabama A&M,30,8,22,0.267,6025,656,1727,502,1179,154,548,379,565,286,749,1035,326,174,63,391,538,1845,0.38,0.426,0.281,0.671,0.462,0.424
1764,2023-24,Alabama,37,25,12,0.676,7450,1136,2385,723,1277,413,1108,650,842,472,995,1467,587,256,162,438,734,3335,0.476,0.566,0.373,0.772,0.599,0.563
1765,2022-23,Alabama,37,31,6,0.838,7550,1023,2314,657,1221,366,1093,615,848,484,1168,1652,555,224,189,512,691,3027,0.442,0.538,0.335,0.725,0.557,0.521
1766,2021-22,Alabama,33,19,14,0.576,6625,911,2072,606,1085,305,987,496,681,443,863,1306,484,233,155,480,609,2623,0.44,0.559,0.309,0.728,0.547,0.513
1767,2020-21,Alabama,33,26,7,0.788,6625,924,2125,576,1136,348,989,433,612,408,935,1343,464,280,143,458,603,2629,0.435,0.507,0.352,0.708,0.544,0.517
1768,2019-20,Alabama,31,16,15,0.516,6300,854,1956,520,999,334,957,500,721,361,859,1220,441,196,136,461,622,2542,0.437,0.521,0.349,0.693,0.553,0.522
1769,2023-24,Akron,35,24,11,0.686,7025,915,2018,635,1155,280,863,467,642,363,915,1278,455,197,100,394,583,2577,0.453,0.55,0.324,0.727,0.555,0.523
1770,2022-23,Akron,33,22,11,0.667,6650,844,1898,544,1053,300,845,475,643,335,843,1178,443,199,87,370,529,2463,0.445,0.517,0.355,0.739,0.559,0.524
1771,2021-22,Akron,34,24,10,0.706,6825,827,1799,562,1051,265,748,483,701,334,854,1188,396,199,110,388,536,2402,0.46,0.535,0.354,0.689,0.563,0.533
1772,2020-21,Akron,23,15,8,0.652,4650,628,1415,411,763,217,652,325,429,262,633,895,305,113,84,271,413,1798,0.444,0.539,0.333,0.758,0.555,0.52
1773,2019-20,Akron,31,24,7,0.774,6200,788,1789,501,994,287,795,485,628,302,867,1169,405,158,91,397,548,2348,0.44,0.504,0.361,0.772,0.562,0.521
1774,2023-24,Air Force,31,9,22,0.29,6250,727,1604,454,847,273,757,324,475,225,647,872,451,202,122,372,541,2051,0.453,0.536,0.361,0.682,0.56,0.538
1775,2022-23,Air Force,32,14,18,0.438,6475,756,1636,495,903,261,733,369,511,213,733,946,491,184,127,391,544,2142,0.462,0.548,0.356,0.722,0.57,0.542
1776,2021-22,Air Force,29,11,18,0.379,5800,627,1437,419,812,208,625,250,385,172,598,770,362,158,88,395,523,1712,0.436,0.516,0.333,0.649,0.528,0.509
1777,2020-21,Air Force,25,5,20,0.2,5000,522,1170,348,643,174,527,250,361,110,470,580,308,177,62,361,415,1468,0.446,0.541,0.33,0.693,0.547,0.521
1778,2019-20,Air Force,32,12,20,0.375,6400,802,1759,527,1025,275,734,459,628,237,803,1040,469,161,43,395,534,2338,0.456,0.514,0.375,0.731,0.568,0.534
1779,2023-24,Abilene Christian,34,16,18,0.471,6875,861,1987,681,1457,180,530,550,757,329,810,1139,431,262,72,434,665,2452,0.433,0.467,0.34,0.727,0.522,0.479
1780,2022-23,Abilene Christian,30,13,17,0.433,6050,812,1800,601,1187,211,613,414,573,307,665,972,471,264,71,379,617,2249,0.451,0.506,0.344,0.723,0.543,0.51
1781,2021-22,Abilene Christian,36,25,11,0.694,7300,946,2159,699,1386,247,773,622,825,376,779,1155,538,391,67,453,801,2761,0.438,0.504,0.32,0.754,0.541,0.495
1782,2020-21,Abilene Christian,29,24,5,0.828,5800,786,1752,565,1109,221,643,403,594,329,718,1047,513,282,86,394,554,2196,0.449,0.509,0.344,0.678,0.54,0.512
1783,2019-20,Abilene Christian,31,20,11,0.645,6300,814,1813,605,1137,209,676,515,695,337,705,1042,461,293,81,436,661,2352,0.449,0.532,0.309,0.741,0.549,0.507
