Rk,Season,Team,G,W,L,W/L%,opp_FG,opp_FGA,opp_2P,opp_2PA,opp_3P,opp_3PA,opp_FT,opp_FTA,opp_ORB,opp_DRB,opp_TRB,opp_AST,opp_STL,opp_BLK,opp_TOV,opp_PF,opp_PTS,opp_FG%,opp_2P%,opp_3P%,opp_FT%
1,2023-24,Youngstown State,32,22,10,0.688,821,1966,581,1244,240,722,387,555,336,761,1097,450,191,92,383,546,2269,0.418,0.467,0.332,0.697
2,2022-23,Youngstown State,34,24,10,0.706,929,2065,691,1367,238,698,369,525,347,780,1127,456,176,83,438,553,2465,0.45,0.505,0.341,0.703
3,2021-22,Youngstown State,34,19,15,0.559,865,1964,626,1261,239,703,405,563,320,787,1107,426,201,106,401,589,2374,0.44,0.496,0.34,0.719
4,2020-21,Youngstown State,27,15,12,0.556,718,1569,499,947,219,622,295,411,257,683,940,377,155,83,385,472,1950,0.458,0.527,0.352,0.718
5,2019-20,Youngstown State,33,18,15,0.545,855,1951,633,1305,222,646,419,599,347,813,1160,420,187,110,398,569,2351,0.438,0.485,0.344,0.699
6,2023-24,Yale,33,23,10,0.697,788,1873,523,1089,265,784,385,523,273,803,1076,451,182,111,365,531,2226,0.421,0.48,0.338,0.736
7,2022-23,Yale,30,21,9,0.7,653,1650,437,977,216,673,375,540,251,706,957,329,174,84,378,508,1897,0.396,0.447,0.321,0.694
8,2021-22,Yale,31,19,12,0.613,761,1798,534,1054,227,744,394,572,298,804,1102,369,226,110,408,542,2143,0.423,0.507,0.305,0.689
9,2019-20,Yale,30,23,7,0.767,704,1774,482,1056,222,718,324,449,237,724,961,358,202,90,364,521,1954,0.397,0.456,0.309,0.722
10,2023-24,Xavier,34,16,18,0.471,921,2111,671,1364,250,747,446,626,365,858,1223,549,213,164,389,600,2538,0.436,0.492,0.335,0.712
11,2022-23,Xavier,37,27,10,0.73,1012,2285,738,1520,274,765,443,618,339,856,1195,542,258,143,434,654,2741,0.443,0.486,0.358,0.717
12,2021-22,Xavier,36,23,13,0.639,912,2150,659,1364,253,786,415,556,340,897,1237,443,244,125,457,644,2492,0.424,0.483,0.322,0.746
13,2020-21,Xavier,21,13,8,0.619,541,1310,376,822,165,488,227,308,222,546,768,308,116,58,242,341,1474,0.413,0.457,0.338,0.737
14,2019-20,Xavier,32,19,13,0.594,776,1900,566,1211,210,689,400,550,328,799,1127,385,225,108,420,575,2162,0.408,0.467,0.305,0.727
15,2023-24,Wyoming,32,15,17,0.469,868,1914,606,1147,262,767,385,519,322,747,1069,421,261,123,360,622,2383,0.454,0.528,0.342,0.742
16,2022-23,Wyoming,31,9,22,0.29,796,1733,548,1049,248,684,394,500,251,773,1024,389,190,96,346,537,2234,0.459,0.522,0.363,0.788
17,2021-22,Wyoming,34,25,9,0.735,825,1992,595,1231,230,761,347,481,297,820,1117,349,176,90,364,655,2227,0.414,0.483,0.302,0.721
18,2020-21,Wyoming,25,14,11,0.56,694,1452,545,1001,149,451,351,492,236,683,919,316,140,81,320,487,1888,0.478,0.544,0.33,0.713
19,2019-20,Wyoming,33,9,24,0.273,795,1837,543,1073,252,764,466,671,318,947,1265,399,198,84,424,580,2308,0.433,0.506,0.33,0.694
20,2023-24,Wright State,32,18,14,0.563,953,2011,679,1251,274,760,419,587,318,723,1041,429,235,85,390,574,2599,0.474,0.543,0.361,0.714
21,2022-23,Wright State,33,18,15,0.545,897,2062,635,1264,262,798,376,555,330,808,1138,373,262,91,434,519,2432,0.435,0.502,0.328,0.677
22,2021-22,Wright State,36,22,14,0.611,972,2149,725,1406,247,743,394,551,366,846,1212,403,265,105,469,644,2585,0.452,0.516,0.332,0.715
23,2020-21,Wright State,24,18,6,0.75,615,1534,461,1030,154,504,234,334,244,547,791,272,172,51,290,465,1618,0.401,0.448,0.306,0.701
24,2019-20,Wright State,32,25,7,0.781,842,2026,642,1361,200,665,380,534,369,818,1187,339,201,93,455,647,2264,0.416,0.472,0.301,0.712
25,2023-24,Wofford,32,17,15,0.531,812,1875,532,1075,280,800,458,615,278,779,1057,407,209,88,305,527,2362,0.433,0.495,0.35,0.745
26,2022-23,Wofford,33,17,16,0.515,878,1908,600,1107,278,801,358,489,287,736,1023,401,189,101,369,533,2392,0.46,0.542,0.347,0.732
27,2021-22,Wofford,32,19,13,0.594,747,1665,472,898,275,767,351,474,199,686,885,368,196,78,424,533,2120,0.449,0.526,0.359,0.741
28,2020-21,Wofford,24,15,9,0.625,599,1373,404,793,195,580,234,341,215,564,779,290,154,67,311,375,1627,0.436,0.509,0.336,0.686
29,2019-20,Wofford,35,19,16,0.543,843,1915,567,1088,276,827,437,610,272,814,1086,427,211,84,434,556,2399,0.44,0.521,0.334,0.716
30,2023-24,Wisconsin,36,22,14,0.611,896,1961,648,1289,248,672,480,663,278,835,1113,424,181,144,406,658,2520,0.457,0.503,0.369,0.724
31,2022-23,Wisconsin,35,20,15,0.571,831,1871,614,1185,217,686,346,515,276,952,1228,358,158,125,413,569,2225,0.444,0.518,0.316,0.672
32,2021-22,Wisconsin,33,25,8,0.758,813,1870,609,1242,204,628,347,508,274,877,1151,381,155,109,377,624,2177,0.435,0.49,0.325,0.683
33,2020-21,Wisconsin,31,18,13,0.581,729,1726,535,1147,194,579,351,491,260,824,1084,385,135,115,356,501,2003,0.422,0.466,0.335,0.715
34,2019-20,Wisconsin,31,21,10,0.677,717,1747,529,1179,188,568,305,442,280,790,1070,342,154,92,339,518,1927,0.41,0.449,0.331,0.69
35,2023-24,Winthrop,32,17,15,0.531,785,1864,534,1070,251,794,466,618,356,732,1088,384,218,125,426,702,2287,0.421,0.499,0.316,0.754
36,2022-23,Winthrop,32,15,17,0.469,888,1890,635,1169,253,721,353,553,367,722,1089,450,240,123,388,651,2382,0.47,0.543,0.351,0.638
37,2021-22,Winthrop,32,23,9,0.719,784,1820,526,1082,258,738,420,596,289,723,1012,351,234,81,434,609,2246,0.431,0.486,0.35,0.705
38,2020-21,Winthrop,25,23,2,0.92,597,1384,432,874,165,510,317,476,190,596,786,260,147,88,398,524,1676,0.431,0.494,0.324,0.666
39,2019-20,Winthrop,34,24,10,0.706,833,1909,598,1180,235,729,530,793,295,832,1127,421,219,111,497,693,2431,0.436,0.507,0.322,0.668
40,2023-24,William & Mary,33,10,23,0.303,840,1890,610,1195,230,695,470,639,321,871,1192,387,190,128,323,556,2380,0.444,0.51,0.331,0.736
41,2022-23,William & Mary,33,13,20,0.394,864,1861,627,1181,237,680,355,506,310,801,1111,422,204,163,373,523,2320,0.464,0.531,0.349,0.702
42,2021-22,William & Mary,32,5,27,0.156,878,1907,614,1119,264,788,360,513,294,849,1143,459,291,154,408,523,2380,0.46,0.549,0.335,0.702
43,2020-21,William & Mary,17,7,10,0.412,465,1027,349,671,116,356,176,242,188,425,613,245,120,90,195,293,1224,0.453,0.52,0.326,0.727
44,2019-20,William & Mary,32,21,11,0.656,811,1905,577,1232,234,673,352,493,269,750,1019,364,212,90,316,526,2208,0.426,0.468,0.348,0.714
45,2023-24,Wichita State,34,15,19,0.441,895,2126,631,1317,264,809,430,590,372,835,1207,471,271,133,348,494,2484,0.421,0.479,0.326,0.729
46,2022-23,Wichita State,32,17,15,0.531,784,1931,519,1143,265,788,358,501,334,760,1094,446,222,107,373,493,2191,0.406,0.454,0.336,0.715
47,2021-22,Wichita State,28,15,13,0.536,664,1602,478,1013,186,589,344,486,278,698,976,347,188,106,387,461,1858,0.414,0.472,0.316,0.708
48,2020-21,Wichita State,22,16,6,0.727,533,1326,383,820,150,506,253,371,266,602,868,272,119,63,286,396,1469,0.402,0.467,0.296,0.682
49,2019-20,Wichita State,31,23,8,0.742,669,1713,487,1110,182,603,457,657,268,804,1072,314,193,124,443,575,1977,0.391,0.439,0.302,0.696
50,2023-24,Western Michigan,32,12,20,0.375,857,1930,606,1194,251,736,431,597,342,786,1128,440,221,72,352,564,2396,0.444,0.508,0.341,0.722
51,2022-23,Western Michigan,31,8,23,0.258,820,1774,563,1062,257,712,398,557,273,727,1000,445,195,89,305,497,2295,0.462,0.53,0.361,0.715
52,2021-22,Western Michigan,31,8,23,0.258,846,1842,602,1103,244,739,393,558,335,780,1115,414,222,118,318,452,2329,0.459,0.546,0.33,0.704
53,2020-21,Western Michigan,21,5,16,0.238,560,1291,404,795,156,496,235,324,220,542,762,233,163,52,213,329,1511,0.434,0.508,0.315,0.725
54,2019-20,Western Michigan,32,13,19,0.406,833,1923,595,1203,238,720,402,584,336,838,1174,391,201,97,368,615,2306,0.433,0.495,0.331,0.688
55,2023-24,Western Kentucky,34,22,12,0.647,889,2144,610,1267,279,877,474,687,361,882,1243,444,247,147,480,608,2531,0.415,0.481,0.318,0.69
56,2022-23,Western Kentucky,33,17,16,0.515,842,2006,539,1156,303,850,343,491,379,853,1232,433,200,76,415,553,2330,0.42,0.466,0.356,0.699
57,2021-22,Western Kentucky,32,19,13,0.594,842,2017,538,1126,304,891,226,319,358,829,1187,499,209,91,460,522,2214,0.417,0.478,0.341,0.708
58,2020-21,Western Kentucky,29,21,8,0.724,722,1710,477,1037,245,673,283,383,251,655,906,360,195,113,381,510,1972,0.422,0.46,0.364,0.739
59,2019-20,Western Kentucky,30,20,10,0.667,828,1879,612,1159,216,720,288,392,335,746,1081,390,166,90,409,553,2160,0.441,0.528,0.3,0.735
60,2023-24,Western Illinois,33,21,12,0.636,819,2018,633,1392,186,626,343,475,346,775,1121,354,244,107,334,573,2167,0.406,0.455,0.297,0.722
61,2022-23,Western Illinois,30,16,14,0.533,822,1782,630,1192,192,590,335,468,272,767,1039,318,151,86,353,543,2171,0.461,0.529,0.325,0.716
62,2021-22,Western Illinois,32,16,16,0.5,890,1920,653,1284,237,636,453,583,236,895,1131,398,171,95,399,608,2470,0.464,0.509,0.373,0.777
63,2020-21,Western Illinois,22,7,15,0.318,608,1286,435,847,173,439,357,491,173,630,803,310,127,92,266,448,1746,0.473,0.514,0.394,0.727
64,2019-20,Western Illinois,26,5,21,0.192,757,1582,549,1025,208,557,404,540,219,779,998,318,128,70,300,409,2126,0.479,0.536,0.373,0.748
65,2023-24,Western Carolina,32,22,10,0.688,789,1934,588,1322,201,612,419,595,305,802,1107,286,168,88,311,521,2198,0.408,0.445,0.328,0.704
66,2022-23,Western Carolina,34,18,16,0.529,871,1987,674,1382,197,605,466,648,296,893,1189,376,193,119,368,579,2405,0.438,0.488,0.326,0.719
67,2021-22,Western Carolina,32,11,21,0.344,871,1960,555,1075,316,885,414,575,319,881,1200,461,201,109,324,513,2472,0.444,0.516,0.357,0.72
68,2020-21,Western Carolina,27,11,16,0.407,785,1688,543,1017,242,671,317,459,233,710,943,377,195,71,321,526,2129,0.465,0.534,0.361,0.691
69,2019-20,Western Carolina,31,19,12,0.613,828,1906,585,1125,243,781,418,581,287,743,1030,377,206,108,387,615,2317,0.434,0.52,0.311,0.719
70,2023-24,West Virginia,32,9,23,0.281,878,1969,582,1123,296,846,407,553,343,804,1147,498,242,124,332,586,2459,0.446,0.518,0.35,0.736
71,2022-23,West Virginia,34,19,15,0.559,834,1857,612,1205,222,652,521,718,319,743,1062,420,227,82,496,728,2411,0.449,0.508,0.34,0.726
72,2021-22,West Virginia,33,16,17,0.485,809,1814,592,1145,217,669,441,619,359,831,1190,430,228,94,508,630,2276,0.446,0.517,0.324,0.712
73,2020-21,West Virginia,29,19,10,0.655,769,1721,550,1068,219,653,332,481,313,708,1021,405,178,82,434,590,2089,0.447,0.515,0.335,0.69
74,2019-20,West Virginia,31,21,10,0.677,655,1677,474,1048,181,629,444,621,299,704,1003,312,227,104,484,666,1935,0.391,0.452,0.288,0.715
75,2023-24,Weber State,32,20,12,0.625,799,1743,579,1107,220,636,343,485,235,794,1029,409,163,87,405,562,2161,0.458,0.523,0.346,0.707
76,2022-23,Weber State,33,18,15,0.545,789,1762,518,1032,271,730,380,544,238,807,1045,460,185,99,429,583,2229,0.448,0.502,0.371,0.699
77,2021-22,Weber State,33,21,12,0.636,844,1919,566,1163,278,756,353,488,270,831,1101,430,176,58,482,631,2319,0.44,0.487,0.368,0.723
78,2020-21,Weber State,23,17,6,0.739,569,1341,407,863,162,478,294,410,196,518,714,291,142,53,328,436,1594,0.424,0.472,0.339,0.717
79,2019-20,Weber State,32,12,20,0.375,867,1941,632,1280,235,661,311,436,294,813,1107,455,196,82,375,525,2280,0.447,0.494,0.356,0.713
80,2023-24,Washington State,35,25,10,0.714,834,1979,634,1363,200,616,467,639,309,798,1107,380,197,92,365,594,2335,0.421,0.465,0.325,0.731
81,2022-23,Washington State,34,17,17,0.5,836,1875,642,1272,194,603,369,533,288,801,1089,403,199,93,366,569,2235,0.446,0.505,0.322,0.692
82,2021-22,Washington State,37,22,15,0.595,859,2068,638,1346,221,722,461,627,382,921,1303,413,180,113,512,660,2400,0.415,0.474,0.306,0.735
83,2020-21,Washington State,27,14,13,0.519,649,1565,488,1051,161,514,362,512,254,682,936,363,188,95,352,510,1821,0.415,0.464,0.313,0.707
84,2019-20,Washington State,32,16,16,0.5,820,1826,636,1242,184,584,405,589,286,903,1189,367,185,120,480,593,2229,0.449,0.512,0.315,0.688
85,2023-24,Washington,32,17,15,0.531,886,2003,651,1305,235,698,461,663,346,811,1157,455,206,111,371,590,2468,0.442,0.499,0.337,0.695
86,2022-23,Washington,32,16,16,0.5,834,2005,614,1264,220,741,360,509,422,796,1218,501,223,114,413,557,2250,0.416,0.486,0.297,0.707
87,2021-22,Washington,32,17,15,0.531,842,1903,625,1255,217,648,413,574,394,849,1243,457,169,123,503,619,2314,0.442,0.498,0.335,0.72
88,2020-21,Washington,26,5,21,0.192,719,1583,536,1059,183,524,391,549,313,699,1012,411,152,79,318,434,2012,0.454,0.506,0.349,0.712
89,2019-20,Washington,32,15,17,0.469,732,1920,503,1186,229,734,433,602,394,748,1142,442,217,66,438,599,2126,0.381,0.424,0.312,0.719
90,2023-24,Wake Forest,35,21,14,0.6,885,2045,645,1320,240,725,463,616,313,827,1140,378,205,121,397,615,2473,0.433,0.489,0.331,0.752
91,2022-23,Wake Forest,33,19,14,0.576,892,1990,623,1221,269,769,382,531,310,832,1142,413,230,124,403,591,2435,0.448,0.51,0.35,0.719
92,2021-22,Wake Forest,35,25,10,0.714,880,2129,628,1347,252,782,440,626,346,834,1180,430,278,91,445,630,2452,0.413,0.466,0.322,0.703
93,2020-21,Wake Forest,22,6,16,0.273,569,1213,402,771,167,442,278,396,181,568,749,307,167,104,269,330,1583,0.469,0.521,0.378,0.702
94,2019-20,Wake Forest,31,13,18,0.419,819,1869,599,1209,220,660,463,658,300,786,1086,408,233,111,337,629,2321,0.438,0.495,0.333,0.704
95,2023-24,Wagner,33,17,16,0.515,753,1786,535,1059,218,727,359,525,300,862,1162,444,158,106,367,462,2083,0.422,0.505,0.3,0.684
96,2022-23,Wagner,28,15,13,0.536,568,1324,417,845,151,479,440,616,202,663,865,305,166,106,377,404,1727,0.429,0.493,0.315,0.714
97,2021-22,Wagner,27,21,6,0.778,600,1438,432,870,168,568,379,566,251,620,871,312,168,80,419,477,1747,0.417,0.497,0.296,0.67
98,2020-21,Wagner,20,13,7,0.65,450,1036,308,625,142,411,332,459,182,463,645,263,125,74,284,332,1374,0.434,0.493,0.345,0.723
99,2019-20,Wagner,29,8,21,0.276,726,1580,474,925,252,655,506,717,277,732,1009,439,196,94,382,506,2210,0.459,0.512,0.385,0.706
100,2023-24,VMI,32,4,28,0.125,969,2092,676,1271,293,821,413,628,361,889,1250,491,292,101,375,507,2644,0.463,0.532,0.357,0.658
101,2022-23,VMI,32,7,25,0.219,879,1883,536,948,343,935,356,506,285,799,1084,529,200,132,339,450,2457,0.467,0.565,0.367,0.704
102,2021-22,VMI,32,16,16,0.5,843,2031,524,1085,319,946,370,498,357,818,1175,399,221,97,332,482,2375,0.415,0.483,0.337,0.743
103,2020-21,VMI,25,13,12,0.52,700,1640,461,932,239,708,258,382,249,664,913,326,172,65,257,407,1897,0.427,0.495,0.338,0.675
104,2019-20,VMI,33,9,24,0.273,801,1855,564,1115,237,740,507,704,323,864,1187,434,189,93,428,494,2346,0.432,0.506,0.32,0.72
105,2023-24,Virginia Tech,34,19,15,0.559,879,1943,656,1285,223,658,432,587,297,788,1085,433,218,103,391,573,2413,0.452,0.511,0.339,0.736
106,2022-23,Virginia Tech,34,19,15,0.559,892,2000,650,1288,242,712,357,503,323,825,1148,424,191,119,371,530,2383,0.446,0.505,0.34,0.71
107,2021-22,Virginia Tech,36,23,13,0.639,831,1933,601,1220,230,713,369,495,301,790,1091,424,228,109,429,535,2261,0.43,0.493,0.323,0.745
108,2020-21,Virginia Tech,22,15,7,0.682,513,1210,357,739,156,471,269,386,178,530,708,236,128,73,266,382,1451,0.424,0.483,0.331,0.697
109,2019-20,Virginia Tech,32,16,16,0.5,771,1852,517,1064,254,788,332,484,289,901,1190,411,132,102,382,447,2128,0.416,0.486,0.322,0.686
110,2023-24,Virginia,34,23,11,0.676,732,1805,514,1090,218,715,349,466,316,865,1181,381,170,108,408,444,2033,0.406,0.472,0.305,0.749
111,2022-23,Virginia,33,25,8,0.758,712,1717,478,1030,234,687,338,452,262,793,1055,377,159,123,403,536,1996,0.415,0.464,0.341,0.748
112,2021-22,Virginia,35,21,14,0.6,783,1842,551,1151,232,691,306,430,322,779,1101,406,191,125,385,499,2104,0.425,0.479,0.336,0.712
113,2020-21,Virginia,25,18,7,0.72,550,1321,382,826,168,495,245,327,182,556,738,291,124,58,233,306,1513,0.416,0.462,0.339,0.749
114,2019-20,Virginia,30,23,7,0.767,573,1553,379,891,194,662,231,336,237,679,916,271,199,82,352,417,1571,0.369,0.425,0.293,0.688
115,2023-24,Villanova,34,18,16,0.529,788,1926,502,1054,286,872,369,501,287,870,1157,451,188,135,361,484,2231,0.409,0.476,0.328,0.737
116,2022-23,Villanova,34,17,17,0.5,817,1871,553,1091,264,780,403,519,280,842,1122,491,189,104,384,524,2301,0.437,0.507,0.338,0.776
117,2021-22,Villanova,38,30,8,0.789,861,2111,587,1220,274,891,387,527,378,865,1243,430,180,128,447,620,2383,0.408,0.481,0.308,0.734
118,2020-21,Villanova,25,18,7,0.72,612,1388,419,825,193,563,246,355,207,611,818,299,100,69,303,417,1663,0.441,0.508,0.343,0.693
119,2019-20,Villanova,31,24,7,0.774,784,1822,596,1243,188,579,302,430,271,789,1060,373,176,98,355,503,2058,0.43,0.479,0.325,0.702
120,2023-24,Vermont,35,28,7,0.8,805,1982,582,1272,223,710,372,521,289,894,1183,345,180,113,351,529,2205,0.406,0.458,0.314,0.714
121,2022-23,Vermont,34,23,11,0.676,835,1866,589,1179,246,687,360,497,241,862,1103,380,171,90,389,527,2276,0.447,0.5,0.358,0.724
122,2021-22,Vermont,34,28,6,0.824,765,1864,524,1163,241,701,294,425,216,772,988,335,164,96,377,550,2065,0.41,0.451,0.344,0.692
123,2020-21,Vermont,15,10,5,0.667,330,810,229,486,101,324,190,271,120,347,467,145,76,33,192,291,951,0.407,0.471,0.312,0.701
124,2019-20,Vermont,33,26,7,0.788,673,1773,441,1041,232,732,385,541,268,806,1074,338,189,83,422,572,1963,0.38,0.424,0.317,0.712
125,2023-24,VCU,38,24,14,0.632,870,2138,610,1307,260,831,534,728,366,893,1259,428,270,86,425,639,2534,0.407,0.467,0.313,0.734
126,2022-23,VCU,35,27,8,0.771,789,1903,582,1254,207,649,417,592,358,799,1157,405,229,124,572,689,2202,0.415,0.464,0.319,0.704
127,2021-22,VCU,32,22,10,0.688,679,1722,507,1104,172,618,467,660,364,738,1102,366,250,85,544,552,1997,0.394,0.459,0.278,0.708
128,2020-21,VCU,27,19,7,0.731,590,1457,434,946,156,511,358,516,293,612,905,302,168,81,436,453,1694,0.405,0.459,0.305,0.694
129,2019-20,VCU,31,18,13,0.581,702,1661,507,1083,195,578,421,596,315,808,1123,369,206,98,527,526,2020,0.423,0.468,0.337,0.706
130,2023-24,Vanderbilt,32,9,23,0.281,858,1881,580,1137,278,744,434,555,314,875,1189,473,181,112,347,558,2428,0.456,0.51,0.374,0.782
131,2022-23,Vanderbilt,37,22,15,0.595,954,2219,706,1420,248,799,489,693,432,936,1368,470,210,98,381,646,2645,0.43,0.497,0.31,0.706
132,2021-22,Vanderbilt,36,19,17,0.528,851,1996,617,1219,234,777,506,696,340,917,1257,471,230,137,516,704,2442,0.426,0.506,0.301,0.727
133,2020-21,Vanderbilt,25,9,16,0.36,646,1411,468,885,178,526,339,475,237,630,867,340,170,105,345,439,1809,0.458,0.529,0.338,0.714
134,2019-20,Vanderbilt,32,11,21,0.344,846,1811,631,1198,215,613,492,667,311,845,1156,429,181,129,443,646,2399,0.467,0.527,0.351,0.738
135,2023-24,Valparaiso,32,7,25,0.219,893,1870,659,1209,234,661,396,571,322,911,1233,487,205,80,396,491,2416,0.478,0.545,0.354,0.694
136,2022-23,Valparaiso,32,11,21,0.344,843,1882,604,1178,239,704,430,586,273,843,1116,444,224,82,355,480,2355,0.448,0.513,0.339,0.734
137,2021-22,Valparaiso,32,14,18,0.438,853,1872,611,1188,242,684,309,416,216,853,1069,430,186,97,366,452,2257,0.456,0.514,0.354,0.743
138,2020-21,Valparaiso,28,10,18,0.357,701,1606,510,1032,191,574,309,446,252,780,1032,370,170,68,365,427,1902,0.436,0.494,0.333,0.693
139,2019-20,Valparaiso,35,19,16,0.543,908,1998,657,1304,251,694,427,618,323,925,1248,472,221,91,496,563,2494,0.454,0.504,0.362,0.691
140,2023-24,UTSA,32,11,21,0.344,908,2032,628,1271,280,761,495,699,348,873,1221,477,195,144,303,568,2591,0.447,0.494,0.368,0.708
141,2022-23,UTSA,32,10,22,0.313,883,1961,629,1227,254,734,430,608,358,823,1181,449,221,154,354,594,2450,0.45,0.513,0.346,0.707
142,2021-22,UTSA,32,10,22,0.313,840,1841,584,1128,256,713,377,588,280,902,1182,476,218,121,397,505,2313,0.456,0.518,0.359,0.641
143,2020-21,UTSA,26,15,11,0.577,650,1537,451,948,199,589,407,545,250,702,952,328,144,80,361,409,1906,0.423,0.476,0.338,0.747
144,2019-20,UTSA,32,13,19,0.406,854,1945,593,1183,261,762,496,707,316,930,1246,411,183,114,446,580,2465,0.439,0.501,0.343,0.702
145,2023-24,UTEP,34,18,16,0.529,798,1768,604,1160,194,608,558,792,336,834,1170,374,255,123,636,660,2348,0.451,0.521,0.319,0.705
146,2022-23,UTEP,32,14,18,0.438,767,1718,553,1075,214,643,444,620,301,749,1050,340,252,111,536,625,2192,0.446,0.514,0.333,0.716
147,2021-22,UTEP,34,20,14,0.588,808,1832,603,1219,205,613,444,692,333,897,1230,405,190,74,498,527,2265,0.441,0.495,0.334,0.642
148,2020-21,UTEP,24,12,12,0.5,573,1322,425,892,148,430,350,491,193,656,849,266,124,65,316,380,1644,0.433,0.476,0.344,0.713
149,2019-20,UTEP,32,17,15,0.531,743,1788,543,1132,200,656,430,602,292,836,1128,351,185,83,439,569,2116,0.416,0.48,0.305,0.714
150,2023-24,Utah Valley,32,16,16,0.5,774,1834,572,1205,202,629,445,641,308,840,1148,448,225,118,409,577,2195,0.422,0.475,0.321,0.694
151,2022-23,Utah Valley,37,28,9,0.757,928,2380,693,1614,235,766,447,669,447,907,1354,418,249,111,458,706,2538,0.39,0.429,0.307,0.668
152,2021-22,Utah Valley,32,20,12,0.625,760,1930,555,1208,205,722,359,529,313,714,1027,389,247,101,357,633,2084,0.394,0.459,0.284,0.679
153,2020-21,Utah Valley,22,11,11,0.5,565,1325,408,867,157,458,348,459,193,520,713,304,148,68,249,470,1635,0.426,0.471,0.343,0.758
154,2019-20,Utah Valley,30,11,19,0.367,757,1785,585,1252,172,533,445,598,285,790,1075,362,185,111,377,576,2131,0.424,0.467,0.323,0.744
155,2023-24,Utah Tech,31,11,20,0.355,802,1819,575,1149,227,670,558,769,351,775,1126,420,272,112,416,607,2389,0.441,0.5,0.339,0.726
156,2022-23,Utah Tech,33,14,19,0.424,854,1851,613,1160,241,691,471,642,287,773,1060,453,232,103,490,705,2420,0.461,0.528,0.349,0.734
157,2023-24,Utah State,35,28,7,0.8,906,2070,685,1315,221,755,464,634,330,827,1157,456,223,84,417,645,2497,0.438,0.521,0.293,0.732
158,2022-23,Utah State,35,26,9,0.743,870,2055,629,1361,241,694,465,624,303,800,1103,413,197,88,388,658,2446,0.423,0.462,0.347,0.745
159,2021-22,Utah State,34,18,16,0.529,818,1905,567,1168,251,737,386,545,266,801,1067,451,211,103,420,570,2273,0.429,0.485,0.341,0.708
160,2020-21,Utah State,29,20,9,0.69,640,1640,419,976,221,664,307,414,222,659,881,334,192,103,396,514,1808,0.39,0.429,0.333,0.742
161,2019-20,Utah State,34,26,8,0.765,778,1987,514,1146,264,841,359,515,278,785,1063,379,227,108,420,654,2179,0.392,0.449,0.314,0.697
162,2023-24,Utah,37,22,15,0.595,1002,2347,715,1492,287,855,417,609,372,972,1344,514,235,118,375,618,2708,0.427,0.479,0.336,0.685
163,2022-23,Utah,32,17,15,0.531,764,1924,560,1248,204,676,311,470,337,784,1121,409,198,121,325,515,2043,0.397,0.449,0.302,0.662
164,2021-22,Utah,31,11,20,0.355,806,1848,593,1200,213,648,372,528,329,787,1116,407,193,113,320,520,2197,0.436,0.494,0.329,0.705
165,2020-21,Utah,25,12,13,0.48,639,1427,456,919,183,508,284,390,250,599,849,328,158,97,335,429,1745,0.448,0.496,0.36,0.728
166,2019-20,Utah,31,16,15,0.516,818,1857,587,1201,231,656,313,428,298,727,1025,415,207,119,377,587,2180,0.44,0.489,0.352,0.731
167,2023-24,UT Martin,32,21,11,0.656,904,2170,616,1284,288,886,359,499,346,874,1220,454,216,130,340,558,2455,0.417,0.48,0.325,0.719
168,2022-23,UT Martin,33,19,14,0.576,877,2076,607,1238,270,838,465,679,361,865,1226,474,208,128,426,590,2489,0.422,0.49,0.322,0.685
169,2021-22,UT Martin,30,8,22,0.267,762,1759,539,1077,223,682,459,639,331,798,1129,423,206,147,386,454,2206,0.433,0.5,0.327,0.718
170,2020-21,UT Martin,24,8,16,0.333,650,1341,443,779,207,562,340,486,257,629,886,413,164,79,348,402,1847,0.485,0.569,0.368,0.7
171,2019-20,UT Martin,29,9,20,0.31,882,1785,596,1043,286,742,332,483,335,689,1024,535,188,88,360,502,2382,0.494,0.571,0.385,0.687
172,2023-24,UT Arlington,34,20,14,0.588,828,1961,588,1270,240,691,596,805,358,785,1143,455,256,121,465,666,2492,0.422,0.463,0.347,0.74
173,2022-23,UT Arlington,32,11,21,0.344,751,1718,513,1065,238,653,450,639,305,774,1079,406,193,102,456,587,2190,0.437,0.482,0.364,0.704
174,2021-22,UT Arlington,29,11,18,0.379,694,1680,458,1012,236,668,369,524,338,724,1062,452,204,88,402,480,1993,0.413,0.453,0.353,0.704
175,2020-21,UT Arlington,26,13,13,0.5,659,1558,462,1006,197,552,312,445,287,731,1018,393,160,80,383,409,1827,0.423,0.459,0.357,0.701
176,2019-20,UT Arlington,32,14,18,0.438,773,1875,577,1213,196,662,447,651,345,883,1228,416,156,98,391,542,2189,0.412,0.476,0.296,0.687
177,2023-24,USC Upstate,30,10,20,0.333,737,1649,548,1050,189,599,525,738,333,805,1138,336,183,91,403,504,2188,0.447,0.522,0.316,0.711
178,2022-23,USC Upstate,32,16,16,0.5,750,1732,539,1100,211,632,514,729,340,787,1127,353,202,82,460,564,2225,0.433,0.49,0.334,0.705
179,2021-22,USC Upstate,32,15,17,0.469,805,1833,559,1084,246,749,485,693,327,827,1154,445,205,108,406,519,2341,0.439,0.516,0.328,0.7
180,2020-21,USC Upstate,23,5,18,0.217,609,1289,440,806,169,483,325,465,225,599,824,321,162,65,301,371,1712,0.472,0.546,0.35,0.699
181,2019-20,USC Upstate,33,13,20,0.394,845,1823,588,1104,257,719,513,713,315,892,1207,407,193,101,451,564,2460,0.464,0.533,0.357,0.719
182,2023-24,UNLV,34,21,13,0.618,835,1954,592,1197,243,757,428,567,362,786,1148,489,209,117,420,564,2341,0.427,0.495,0.321,0.755
183,2022-23,UNLV,32,19,13,0.594,779,1781,496,989,283,792,400,548,328,839,1167,453,196,95,562,612,2241,0.437,0.502,0.357,0.73
184,2021-22,UNLV,32,18,14,0.563,735,1796,500,1047,235,749,394,548,290,830,1120,394,162,92,367,541,2099,0.409,0.478,0.314,0.719
185,2020-21,UNLV,27,12,15,0.444,618,1470,386,833,232,637,354,486,223,652,875,369,136,83,324,400,1822,0.42,0.463,0.364,0.728
186,2019-20,UNLV,32,17,15,0.531,738,1755,486,1003,252,752,514,713,271,770,1041,440,200,108,385,588,2242,0.421,0.485,0.335,0.721
187,2023-24,UNC Wilmington,31,21,10,0.677,792,1762,566,1117,226,645,392,560,321,755,1076,344,124,84,383,559,2202,0.449,0.507,0.35,0.7
188,2022-23,UNC Wilmington,34,24,10,0.706,766,1783,567,1129,199,654,456,650,314,793,1107,305,193,95,473,667,2187,0.43,0.502,0.304,0.702
189,2021-22,UNC Wilmington,36,27,9,0.75,890,2023,655,1359,235,664,468,676,387,944,1331,363,160,104,486,632,2483,0.44,0.482,0.354,0.692
190,2020-21,UNC Wilmington,17,7,10,0.412,463,987,370,695,93,292,234,310,168,437,605,190,90,53,239,319,1253,0.469,0.532,0.318,0.755
191,2019-20,UNC Wilmington,32,10,22,0.313,830,1872,596,1149,234,723,400,587,320,852,1172,407,207,82,417,527,2294,0.443,0.519,0.324,0.681
192,2023-24,UNC Greensboro,32,21,11,0.656,749,1826,483,1023,266,803,469,635,330,753,1083,358,185,85,371,511,2233,0.41,0.472,0.331,0.739
193,2022-23,UNC Greensboro,32,20,12,0.625,728,1799,492,1059,236,740,372,547,304,761,1065,343,186,74,425,560,2064,0.405,0.465,0.319,0.68
194,2021-22,UNC Greensboro,32,17,15,0.531,712,1701,425,880,287,821,368,479,258,696,954,401,221,84,382,508,2079,0.419,0.483,0.35,0.768
195,2020-21,UNC Greensboro,30,21,9,0.7,689,1653,474,969,215,684,427,604,267,824,1091,344,146,83,446,477,2020,0.417,0.489,0.314,0.707
196,2019-20,UNC Greensboro,32,23,9,0.719,699,1649,473,994,226,655,396,589,275,813,1088,345,185,79,575,528,2020,0.424,0.476,0.345,0.672
197,2023-24,UNC Asheville,34,22,12,0.647,884,2054,644,1309,240,745,477,672,387,817,1204,418,210,104,434,677,2485,0.43,0.492,0.322,0.71
198,2022-23,UNC Asheville,35,27,8,0.771,901,2125,684,1394,217,731,399,555,369,827,1196,418,247,126,446,701,2418,0.424,0.491,0.297,0.719
199,2021-22,UNC Asheville,32,17,15,0.531,842,1919,663,1292,179,627,338,506,368,777,1145,395,208,94,432,597,2201,0.439,0.513,0.285,0.668
200,2020-21,UNC Asheville,20,10,10,0.5,533,1192,413,822,120,370,270,385,240,508,748,239,130,82,280,329,1456,0.447,0.502,0.324,0.701
201,2019-20,UNC Asheville,31,15,16,0.484,843,1670,649,1148,194,522,438,662,278,835,1113,428,148,86,515,566,2318,0.505,0.565,0.372,0.662
202,2023-24,UMBC,32,11,21,0.344,948,2131,706,1362,242,769,445,609,385,875,1260,431,259,98,364,503,2583,0.445,0.518,0.315,0.731
203,2022-23,UMBC,32,18,14,0.563,851,1881,579,1160,272,721,354,487,288,825,1113,432,168,92,370,499,2328,0.452,0.499,0.377,0.727
204,2021-22,UMBC,32,18,14,0.563,902,1973,651,1250,251,723,252,383,314,843,1157,412,180,78,368,541,2307,0.457,0.521,0.347,0.658
205,2020-21,UMBC,20,14,6,0.7,463,1167,305,687,158,480,214,299,178,502,680,212,107,56,245,373,1298,0.397,0.444,0.329,0.716
206,2019-20,UMBC,33,16,17,0.485,759,1844,496,1019,263,825,426,570,300,839,1139,385,211,96,439,590,2207,0.412,0.487,0.319,0.747
207,2023-24,UMass Lowell,32,22,10,0.688,851,2055,650,1354,201,701,358,518,332,732,1064,363,254,118,378,600,2261,0.414,0.48,0.287,0.691
208,2022-23,UMass Lowell,34,26,8,0.765,790,1940,578,1306,212,634,451,622,320,709,1029,367,257,106,471,595,2243,0.407,0.443,0.334,0.725
209,2021-22,UMass Lowell,31,15,16,0.484,723,1762,512,1172,211,590,383,532,303,775,1078,316,187,115,431,470,2040,0.41,0.437,0.358,0.72
210,2020-21,UMass Lowell,23,11,12,0.478,556,1304,406,830,150,474,369,515,215,545,760,234,142,61,260,447,1631,0.426,0.489,0.316,0.717
211,2019-20,UMass Lowell,32,13,19,0.406,902,1947,665,1245,237,702,392,549,331,792,1123,440,215,104,430,626,2433,0.463,0.534,0.338,0.714
212,2023-24,UCLA,33,16,17,0.485,741,1747,492,999,249,748,429,616,299,775,1074,372,182,86,388,607,2160,0.424,0.492,0.333,0.696
213,2022-23,UCLA,37,31,6,0.838,812,1992,572,1220,240,772,381,547,350,848,1198,415,171,99,580,608,2245,0.408,0.469,0.311,0.697
214,2021-22,UCLA,35,27,8,0.771,809,1948,571,1206,238,742,400,551,300,861,1161,406,156,111,460,593,2256,0.415,0.473,0.321,0.726
215,2020-21,UCLA,32,22,10,0.688,798,1811,568,1128,230,683,364,510,253,755,1008,397,157,93,377,577,2190,0.441,0.504,0.337,0.714
216,2019-20,UCLA,31,19,12,0.613,710,1656,475,1029,235,627,424,583,260,701,961,337,178,94,403,577,2079,0.429,0.462,0.375,0.727
217,2023-24,UCF,33,17,16,0.515,741,1800,499,1088,242,712,518,711,308,832,1140,427,224,113,469,597,2242,0.412,0.459,0.34,0.729
218,2022-23,UCF,34,19,15,0.559,779,1855,558,1135,221,720,449,620,353,777,1130,416,229,97,504,554,2228,0.42,0.492,0.307,0.724
219,2021-22,UCF,30,18,12,0.6,724,1713,503,1005,221,708,376,510,323,745,1068,398,214,99,424,488,2047,0.423,0.5,0.312,0.737
220,2020-21,UCF,23,11,12,0.478,564,1311,399,807,165,504,304,440,252,549,801,321,159,61,307,378,1597,0.43,0.494,0.327,0.691
221,2019-20,UCF,30,16,14,0.533,727,1731,525,1094,202,637,381,509,324,744,1068,422,205,77,429,537,2037,0.42,0.48,0.317,0.749
222,2023-24,UC Santa Barbara,31,16,15,0.516,848,1871,640,1235,208,636,376,554,292,701,993,382,214,81,310,564,2280,0.453,0.518,0.327,0.679
223,2022-23,UC Santa Barbara,35,27,8,0.771,845,1902,639,1303,206,599,409,546,290,767,1057,408,173,79,430,619,2305,0.444,0.49,0.344,0.749
224,2021-22,UC Santa Barbara,28,17,11,0.607,665,1582,498,1059,167,523,344,468,249,612,861,342,177,70,363,543,1841,0.42,0.47,0.319,0.735
225,2020-21,UC Santa Barbara,27,22,5,0.815,623,1480,466,1005,157,475,293,393,202,601,803,288,124,58,373,479,1696,0.421,0.464,0.331,0.746
226,2019-20,UC Santa Barbara,31,21,10,0.677,751,1673,543,1076,208,597,344,484,247,670,917,355,141,76,374,590,2054,0.449,0.505,0.348,0.711
227,2023-24,UC San Diego,33,21,12,0.636,837,1911,606,1218,231,693,385,539,314,811,1125,412,152,117,381,574,2290,0.438,0.498,0.333,0.714
228,2022-23,UC San Diego,30,10,20,0.333,801,1788,568,1148,233,640,354,487,301,803,1104,447,180,95,344,481,2189,0.448,0.495,0.364,0.727
229,2021-22,UC San Diego,29,13,16,0.448,799,1726,617,1156,182,570,266,373,265,757,1022,375,178,76,351,490,2046,0.463,0.534,0.319,0.713
230,2020-21,UC San Diego,17,7,10,0.412,473,1033,350,687,123,346,157,220,170,472,642,263,117,43,239,240,1226,0.458,0.509,0.355,0.714
231,2023-24,UC Riverside,34,16,18,0.471,877,1901,652,1269,225,632,469,652,279,930,1209,458,154,122,377,581,2448,0.461,0.514,0.356,0.719
232,2022-23,UC Riverside,34,22,12,0.647,841,1848,661,1311,180,537,490,681,250,828,1078,386,202,103,406,567,2352,0.455,0.504,0.335,0.72
233,2021-22,UC Riverside,28,16,12,0.571,665,1596,524,1120,141,476,313,435,221,695,916,320,153,70,303,421,1784,0.417,0.468,0.296,0.72
234,2020-21,UC Riverside,22,14,8,0.636,506,1257,366,818,140,439,248,359,190,533,723,240,108,60,244,322,1400,0.403,0.447,0.319,0.691
235,2019-20,UC Riverside,32,17,15,0.531,692,1712,494,1149,198,563,357,521,233,735,968,343,178,85,346,503,1939,0.404,0.43,0.352,0.685
236,2023-24,UC Irvine,34,24,10,0.706,817,1984,616,1381,201,603,486,682,343,777,1120,399,194,127,421,605,2321,0.412,0.446,0.333,0.713
237,2022-23,UC Irvine,35,23,12,0.657,797,2010,566,1294,231,716,527,722,335,850,1185,404,206,113,445,577,2352,0.397,0.437,0.323,0.73
238,2021-22,UC Irvine,25,15,10,0.6,543,1392,426,942,117,450,304,419,240,565,805,261,154,65,293,407,1507,0.39,0.452,0.26,0.726
239,2020-21,UC Irvine,27,18,9,0.667,603,1559,399,935,204,624,302,430,236,626,862,333,190,64,358,459,1712,0.387,0.427,0.327,0.702
240,2019-20,UC Irvine,32,21,11,0.656,708,1827,487,1196,221,631,450,641,294,671,965,343,175,85,375,520,2087,0.388,0.407,0.35,0.702
241,2023-24,UC Davis,33,20,13,0.606,777,1803,585,1202,192,601,500,684,338,777,1115,375,224,93,481,619,2246,0.431,0.487,0.319,0.731
242,2022-23,UC Davis,32,18,14,0.563,830,1862,625,1303,205,559,409,582,309,741,1050,369,216,105,473,675,2274,0.446,0.48,0.367,0.703
243,2021-22,UC Davis,24,13,11,0.542,552,1332,398,883,154,449,335,477,243,605,848,260,141,55,320,415,1593,0.414,0.451,0.343,0.702
244,2020-21,UC Davis,18,10,8,0.556,448,962,330,625,118,337,275,385,155,442,597,238,112,61,307,358,1289,0.466,0.528,0.35,0.714
245,2019-20,UC Davis,32,14,18,0.438,808,1752,578,1076,230,676,440,610,284,767,1051,469,196,90,445,562,2286,0.461,0.537,0.34,0.721
246,2023-24,UAB,35,23,12,0.657,943,2122,675,1343,268,779,473,655,397,818,1215,463,247,145,403,654,2627,0.444,0.503,0.344,0.722
247,2022-23,UAB,39,29,10,0.744,984,2391,701,1488,283,903,489,673,439,942,1381,480,260,144,552,679,2740,0.412,0.471,0.313,0.727
248,2021-22,UAB,35,27,8,0.771,833,1999,591,1254,242,745,428,606,348,833,1181,390,191,126,553,546,2336,0.417,0.471,0.325,0.706
249,2020-21,UAB,29,22,7,0.759,633,1566,452,997,181,569,301,434,252,742,994,310,122,105,478,477,1748,0.404,0.453,0.318,0.694
250,2019-20,UAB,32,19,13,0.594,748,1804,501,1066,247,738,345,481,275,706,981,353,217,102,392,555,2088,0.415,0.47,0.335,0.717
251,2023-24,Tulsa,31,16,15,0.516,800,1872,567,1151,233,721,457,659,357,818,1175,419,219,74,402,578,2290,0.427,0.493,0.323,0.693
252,2022-23,Tulsa,30,5,25,0.167,864,1822,638,1100,226,722,369,506,339,821,1160,496,224,111,355,475,2323,0.474,0.58,0.313,0.729
253,2021-22,Tulsa,31,11,20,0.355,768,1741,486,963,282,778,349,505,316,763,1079,420,222,120,420,520,2167,0.441,0.505,0.362,0.691
254,2020-21,Tulsa,23,11,12,0.478,520,1272,339,732,181,540,288,441,252,554,806,287,172,58,338,394,1509,0.409,0.463,0.335,0.653
255,2019-20,Tulsa,31,21,10,0.677,690,1735,451,935,239,800,350,491,311,752,1063,369,224,108,455,589,1969,0.398,0.482,0.299,0.713
256,2023-24,Tulane,31,14,17,0.452,869,1999,577,1161,292,838,451,633,388,834,1222,500,210,114,401,608,2481,0.435,0.497,0.348,0.712
257,2022-23,Tulane,31,20,11,0.645,845,1969,550,1142,295,827,407,582,362,881,1243,528,189,144,450,549,2392,0.429,0.482,0.357,0.699
258,2021-22,Tulane,29,14,15,0.483,729,1741,460,953,269,788,353,496,351,785,1136,476,150,127,414,470,2080,0.419,0.483,0.341,0.712
259,2020-21,Tulane,23,10,13,0.435,538,1281,341,730,197,551,256,384,247,643,890,367,122,78,344,388,1529,0.42,0.467,0.358,0.667
260,2019-20,Tulane,30,12,18,0.4,766,1690,517,958,249,732,347,500,309,855,1164,482,156,95,484,545,2128,0.453,0.54,0.34,0.694
261,2023-24,Troy,32,20,12,0.625,777,1815,564,1206,213,609,494,707,338,759,1097,345,259,129,496,587,2261,0.428,0.468,0.35,0.699
262,2022-23,Troy,33,20,13,0.606,770,1814,563,1166,207,648,457,609,325,812,1137,357,218,96,513,581,2204,0.424,0.483,0.319,0.75
263,2021-22,Troy,32,20,12,0.625,737,1782,519,1120,218,662,408,579,302,771,1073,379,263,114,475,553,2100,0.414,0.463,0.329,0.705
264,2020-21,Troy,28,11,17,0.393,696,1627,475,1005,221,622,329,490,262,746,1008,372,224,110,375,516,1942,0.428,0.473,0.355,0.671
265,2019-20,Troy,31,9,22,0.29,787,1768,549,1063,238,705,464,663,319,852,1171,442,210,113,452,552,2276,0.445,0.516,0.338,0.7
266,2023-24,Towson,34,20,14,0.588,770,1833,548,1157,222,676,402,578,311,739,1050,365,214,114,375,539,2164,0.42,0.474,0.328,0.696
267,2022-23,Towson,33,21,12,0.636,774,1845,529,1108,245,737,409,545,300,733,1033,392,184,93,388,535,2202,0.42,0.477,0.332,0.75
268,2021-22,Towson,34,25,9,0.735,762,1840,522,1078,240,762,421,587,299,736,1035,350,161,105,438,593,2185,0.414,0.484,0.315,0.717
269,2020-21,Towson,18,4,14,0.222,478,1067,311,631,167,436,226,313,192,434,626,232,98,59,195,318,1349,0.448,0.493,0.383,0.722
270,2019-20,Towson,32,19,13,0.594,736,1795,486,1021,250,774,403,546,293,719,1012,392,153,88,348,551,2125,0.41,0.476,0.323,0.738
271,2023-24,Toledo,32,20,12,0.625,916,1909,674,1199,242,710,362,500,307,769,1076,434,191,137,418,577,2436,0.48,0.562,0.341,0.724
272,2022-23,Toledo,35,27,8,0.771,981,2128,686,1321,295,807,434,578,372,816,1188,476,179,119,452,651,2691,0.461,0.519,0.366,0.751
273,2021-22,Toledo,34,26,8,0.765,867,2146,594,1257,273,889,327,488,365,831,1196,432,174,158,375,561,2334,0.404,0.473,0.307,0.67
274,2020-21,Toledo,30,21,9,0.7,811,1905,583,1139,228,766,329,451,358,762,1120,368,162,87,374,530,2179,0.426,0.512,0.298,0.729
275,2019-20,Toledo,32,17,15,0.531,817,1956,567,1229,250,727,360,511,337,814,1151,365,209,101,377,596,2244,0.418,0.461,0.344,0.705
276,2023-24,The Citadel,32,11,21,0.344,860,1878,597,1129,263,749,306,420,281,753,1034,467,210,125,354,546,2289,0.458,0.529,0.351,0.729
277,2022-23,The Citadel,32,10,22,0.313,831,1861,571,1084,260,777,452,626,345,841,1186,427,228,109,361,508,2374,0.447,0.527,0.335,0.722
278,2021-22,The Citadel,31,13,18,0.419,871,2019,613,1220,258,799,382,517,328,851,1179,426,214,91,320,525,2382,0.431,0.502,0.323,0.739
279,2020-21,The Citadel,25,13,12,0.52,727,1626,552,1064,175,562,330,435,236,695,931,324,175,74,281,462,1959,0.447,0.519,0.311,0.759
280,2019-20,The Citadel,30,6,24,0.2,886,1948,600,1110,286,838,375,534,321,834,1155,460,230,80,418,520,2433,0.455,0.541,0.341,0.702
281,2023-24,Texas–Rio Grande Valley,31,6,25,0.194,890,1898,669,1260,221,638,472,644,350,873,1223,539,229,139,448,589,2473,0.469,0.531,0.346,0.733
282,2022-23,Texas–Rio Grande Valley,32,15,17,0.469,867,1963,629,1247,238,716,530,718,328,771,1099,532,250,113,414,700,2502,0.442,0.504,0.332,0.738
283,2021-22,Texas–Rio Grande Valley,31,8,23,0.258,857,1920,615,1165,242,755,480,692,389,810,1199,519,216,101,408,639,2438,0.446,0.528,0.321,0.694
284,2020-21,Texas–Rio Grande Valley,19,9,10,0.474,436,1073,331,722,105,351,310,453,224,533,757,259,126,59,355,419,1287,0.406,0.458,0.299,0.684
285,2019-20,Texas–Rio Grande Valley,30,14,16,0.467,728,1582,518,1024,210,558,477,667,271,784,1055,432,163,66,521,564,2143,0.46,0.506,0.376,0.715
286,2023-24,Texas Tech,34,23,11,0.676,864,2009,614,1233,250,776,390,546,369,779,1148,407,202,117,389,581,2368,0.43,0.498,0.322,0.714
287,2022-23,Texas Tech,32,16,16,0.5,785,1872,525,1070,260,802,378,532,341,708,1049,428,228,117,443,551,2208,0.419,0.491,0.324,0.711
288,2021-22,Texas Tech,37,27,10,0.73,763,1977,480,1079,283,898,435,630,334,787,1121,409,250,99,585,674,2244,0.386,0.445,0.315,0.69
289,2020-21,Texas Tech,29,18,11,0.621,631,1533,431,948,200,585,371,545,284,681,965,284,159,87,465,576,1833,0.412,0.455,0.342,0.681
290,2019-20,Texas Tech,31,18,13,0.581,683,1680,498,1081,185,599,413,595,312,723,1035,301,195,100,497,589,1969,0.407,0.461,0.309,0.694
291,2023-24,Texas State,35,17,18,0.486,853,1954,633,1267,220,687,526,724,354,828,1182,406,266,134,453,621,2452,0.437,0.5,0.32,0.727
292,2022-23,Texas State,35,16,19,0.457,800,1799,584,1201,216,598,518,726,298,780,1078,373,218,115,427,584,2334,0.445,0.486,0.361,0.713
293,2021-22,Texas State,29,21,8,0.724,636,1512,439,924,197,588,365,512,270,632,902,341,167,81,428,500,1834,0.421,0.475,0.335,0.713
294,2020-21,Texas State,25,18,7,0.72,537,1274,358,761,179,513,290,416,201,543,744,283,148,72,374,404,1543,0.422,0.47,0.349,0.697
295,2019-20,Texas State,32,21,11,0.656,694,1714,491,1076,203,638,467,652,328,765,1093,350,164,103,469,587,2058,0.405,0.456,0.318,0.716
296,2023-24,Texas Southern,33,16,17,0.485,799,1882,578,1198,221,684,527,742,359,843,1202,424,218,113,418,535,2346,0.425,0.482,0.323,0.71
297,2022-23,Texas Southern,35,14,21,0.4,868,2029,628,1305,240,724,542,759,341,901,1242,409,270,117,481,652,2518,0.428,0.481,0.331,0.714
298,2021-22,Texas Southern,32,19,13,0.594,752,1885,548,1215,204,670,407,629,341,770,1111,365,258,81,388,590,2115,0.399,0.451,0.304,0.647
299,2020-21,Texas Southern,26,17,9,0.654,626,1563,437,953,189,610,365,522,261,667,928,314,165,94,378,501,1806,0.401,0.459,0.31,0.699
300,2019-20,Texas Southern,32,16,16,0.5,858,1964,621,1273,237,691,478,663,349,830,1179,455,245,131,478,676,2431,0.437,0.488,0.343,0.721
301,2023-24,Texas A&M–Corpus Christi,33,21,12,0.636,714,1755,519,1108,195,647,577,815,280,829,1109,360,226,135,494,608,2200,0.407,0.468,0.301,0.708
302,2022-23,Texas A&M–Corpus Christi,35,24,11,0.686,893,1995,605,1135,288,860,487,716,339,836,1175,515,226,119,529,668,2561,0.448,0.533,0.335,0.68
303,2021-22,Texas A&M–Corpus Christi,35,23,12,0.657,809,1942,547,1100,262,842,574,764,344,844,1188,447,226,146,578,692,2454,0.417,0.497,0.311,0.751
304,2020-21,Texas A&M–Corpus Christi,24,5,19,0.208,616,1402,458,915,158,487,326,441,239,632,871,360,205,68,338,426,1716,0.439,0.501,0.324,0.739
305,2019-20,Texas A&M–Corpus Christi,32,14,18,0.438,750,1745,555,1124,195,621,504,690,307,698,1005,392,271,103,419,570,2199,0.43,0.494,0.314,0.73
306,2023-24,Texas A&M–Commerce,33,13,20,0.394,871,1906,670,1325,201,581,519,731,361,920,1281,434,187,115,447,492,2462,0.457,0.506,0.346,0.71
307,2022-23,Texas A&M–Commerce,33,13,20,0.394,848,1835,627,1196,221,639,504,699,322,801,1123,425,213,75,405,532,2421,0.462,0.524,0.346,0.721
308,2023-24,Texas A&M,36,21,15,0.583,898,2095,580,1155,318,940,477,668,355,857,1212,534,191,191,409,710,2591,0.429,0.502,0.338,0.714
309,2022-23,Texas A&M,35,25,10,0.714,783,1924,493,1044,290,880,471,667,373,749,1122,462,251,140,490,699,2327,0.407,0.472,0.33,0.706
310,2021-22,Texas A&M,40,27,13,0.675,924,2230,654,1377,270,853,525,731,465,927,1392,595,289,188,675,704,2643,0.414,0.475,0.317,0.718
311,2020-21,Texas A&M,18,8,10,0.444,432,959,277,504,155,455,186,284,174,406,580,293,120,68,271,307,1205,0.45,0.55,0.341,0.655
312,2019-20,Texas A&M,30,16,14,0.533,679,1659,406,825,273,834,324,432,325,706,1031,434,200,117,444,575,1955,0.409,0.492,0.327,0.75
313,2023-24,Texas,34,21,13,0.618,826,1940,612,1303,214,637,476,660,362,796,1158,392,215,116,438,554,2342,0.426,0.47,0.336,0.721
314,2022-23,Texas,38,29,9,0.763,906,2132,666,1391,240,741,526,719,380,927,1307,421,220,120,595,663,2578,0.425,0.479,0.324,0.732
315,2021-22,Texas,34,22,12,0.647,712,1708,529,1135,183,573,455,668,327,768,1095,314,196,111,507,609,2062,0.417,0.466,0.319,0.681
316,2020-21,Texas,27,19,8,0.704,644,1579,478,1056,166,523,388,567,278,650,928,267,169,84,339,481,1842,0.408,0.453,0.317,0.684
317,2019-20,Texas,31,19,12,0.613,710,1676,558,1204,152,472,390,591,332,766,1098,310,199,95,427,441,1962,0.424,0.463,0.322,0.66
318,2023-24,Tennessee Tech,31,10,21,0.323,857,1867,614,1177,243,690,332,427,288,825,1113,465,212,100,323,483,2289,0.459,0.522,0.352,0.778
319,2022-23,Tennessee Tech,33,16,17,0.485,888,2026,628,1233,260,793,385,519,356,881,1237,504,227,107,437,561,2421,0.438,0.509,0.328,0.742
320,2021-22,Tennessee Tech,32,11,21,0.344,883,1988,625,1193,258,795,333,456,344,803,1147,549,213,106,420,456,2357,0.444,0.524,0.325,0.73
321,2020-21,Tennessee Tech,27,5,22,0.185,776,1615,557,995,219,620,304,431,255,675,930,490,197,78,345,391,2075,0.48,0.56,0.353,0.705
322,2019-20,Tennessee Tech,31,9,22,0.29,827,1784,588,1121,239,663,348,491,292,808,1100,492,216,99,424,415,2241,0.464,0.525,0.36,0.709
323,2023-24,Tennessee State,33,18,15,0.545,790,1873,582,1241,208,632,555,767,372,801,1173,379,228,126,443,582,2343,0.422,0.469,0.329,0.724
324,2022-23,Tennessee State,32,18,14,0.563,809,1845,576,1170,233,675,550,738,303,845,1148,394,202,102,436,615,2401,0.438,0.492,0.345,0.745
325,2021-22,Tennessee State,32,14,18,0.438,770,1774,549,1108,221,666,485,677,308,762,1070,422,222,122,453,531,2246,0.434,0.495,0.332,0.716
326,2020-21,Tennessee State,23,4,19,0.174,575,1292,414,818,161,474,391,559,250,628,878,299,140,96,374,400,1702,0.445,0.506,0.34,0.699
327,2019-20,Tennessee State,33,18,15,0.545,793,1928,566,1198,227,730,532,737,341,737,1078,356,228,89,410,554,2345,0.411,0.472,0.311,0.722
328,2023-24,Tennessee,36,27,9,0.75,814,2091,546,1232,268,859,530,746,382,883,1265,398,226,101,469,652,2426,0.389,0.443,0.312,0.71
329,2022-23,Tennessee,36,25,11,0.694,707,1895,497,1103,210,792,460,640,337,810,1147,356,236,104,528,639,2084,0.373,0.451,0.265,0.719
330,2021-22,Tennessee,35,27,8,0.771,770,1912,535,1162,235,750,428,602,329,850,1179,401,232,99,554,601,2203,0.403,0.46,0.313,0.711
331,2020-21,Tennessee,27,18,9,0.667,599,1492,415,924,184,568,332,456,272,645,917,278,175,73,424,521,1714,0.401,0.449,0.324,0.728
332,2019-20,Tennessee,31,17,14,0.548,685,1704,490,1114,195,590,425,602,327,709,1036,306,236,93,404,604,1990,0.402,0.44,0.331,0.706
333,2023-24,Temple,36,16,20,0.444,912,2085,653,1278,259,807,541,745,374,1026,1400,496,213,134,430,589,2624,0.437,0.511,0.321,0.726
334,2022-23,Temple,32,16,16,0.5,810,1881,597,1247,213,634,414,592,333,775,1108,419,237,93,360,559,2247,0.431,0.479,0.336,0.699
335,2021-22,Temple,29,17,12,0.586,678,1690,496,1072,182,618,389,536,318,732,1050,382,188,101,338,560,1927,0.401,0.463,0.294,0.726
336,2020-21,Temple,16,5,11,0.313,385,944,262,585,123,359,208,299,169,423,592,213,90,55,175,290,1101,0.408,0.448,0.343,0.696
337,2019-20,Temple,31,14,17,0.452,737,1848,497,1073,240,775,390,545,315,867,1182,421,200,131,410,525,2104,0.399,0.463,0.31,0.716
338,2023-24,TCU,34,21,13,0.618,867,1932,643,1254,224,678,481,683,329,774,1103,492,233,132,501,599,2439,0.449,0.513,0.33,0.704
339,2022-23,TCU,35,22,13,0.629,871,2038,651,1324,220,714,433,613,374,847,1221,480,222,154,539,584,2395,0.427,0.492,0.308,0.706
340,2021-22,TCU,34,21,13,0.618,814,1937,605,1261,209,676,370,522,313,727,1040,441,243,115,428,549,2207,0.42,0.48,0.309,0.709
341,2020-21,TCU,26,12,14,0.462,684,1523,507,995,177,528,307,447,267,626,893,402,182,93,301,420,1852,0.449,0.51,0.335,0.687
342,2019-20,TCU,32,16,16,0.5,758,1748,550,1159,208,589,355,535,322,757,1079,473,205,128,451,493,2079,0.434,0.475,0.353,0.664
343,2023-24,Tarleton State,35,25,10,0.714,854,1956,619,1245,235,711,459,663,383,836,1219,413,200,126,502,591,2402,0.437,0.497,0.331,0.692
344,2022-23,Tarleton State,34,17,17,0.5,758,1707,494,968,264,739,528,731,305,827,1132,432,169,120,617,714,2308,0.444,0.51,0.357,0.722
345,2021-22,Tarleton State,31,14,17,0.452,708,1591,493,922,215,669,394,560,313,751,1064,417,160,156,505,558,2025,0.445,0.535,0.321,0.704
346,2020-21,Tarleton State,20,10,10,0.5,398,985,241,530,157,455,293,409,187,485,672,282,69,75,389,374,1246,0.404,0.455,0.345,0.716
347,2023-24,Syracuse,32,20,12,0.625,899,1964,649,1232,250,732,372,511,360,843,1203,456,200,93,463,512,2420,0.458,0.527,0.342,0.728
348,2022-23,Syracuse,32,17,15,0.531,851,1984,522,1026,329,958,302,430,400,759,1159,619,210,88,412,524,2333,0.429,0.509,0.343,0.702
349,2021-22,Syracuse,33,16,17,0.485,887,2083,552,1069,335,1014,368,490,401,847,1248,624,214,111,385,483,2477,0.426,0.516,0.33,0.751
350,2020-21,Syracuse,28,18,10,0.643,707,1724,465,962,242,762,308,415,355,705,1060,484,166,89,391,438,1964,0.41,0.483,0.318,0.742
351,2019-20,Syracuse,32,18,14,0.563,758,1868,470,973,288,895,412,564,385,801,1186,551,187,89,446,567,2216,0.406,0.483,0.322,0.73
352,2023-24,Stony Brook,35,20,15,0.571,908,2148,595,1247,313,901,402,580,384,915,1299,519,210,87,370,542,2531,0.423,0.477,0.347,0.693
353,2022-23,Stony Brook,33,11,22,0.333,824,1935,535,1089,289,846,342,489,317,844,1161,442,239,71,303,522,2279,0.426,0.491,0.342,0.699
354,2021-22,Stony Brook,31,18,13,0.581,855,1878,596,1112,259,766,298,436,322,807,1129,436,180,87,378,501,2267,0.455,0.536,0.338,0.683
355,2020-21,Stony Brook,23,9,14,0.391,533,1308,360,787,173,521,270,386,227,589,816,290,150,67,305,413,1509,0.407,0.457,0.332,0.699
356,2019-20,Stony Brook,33,20,13,0.606,764,1959,489,1137,275,822,369,536,337,838,1175,438,205,92,436,565,2172,0.39,0.43,0.335,0.688
357,2023-24,Stonehill,31,4,27,0.129,826,1875,518,1008,308,867,400,548,346,864,1210,499,244,129,367,438,2360,0.441,0.514,0.355,0.73
358,2022-23,Stonehill,31,14,17,0.452,779,1822,526,1087,253,735,346,493,344,783,1127,425,217,91,419,509,2157,0.428,0.484,0.344,0.702
359,2023-24,Stetson,35,22,13,0.629,957,2168,681,1345,276,823,376,526,390,824,1214,484,208,90,335,581,2566,0.441,0.506,0.335,0.715
360,2022-23,Stetson,31,17,14,0.548,826,1821,582,1129,244,692,391,524,295,739,1034,421,163,74,317,463,2287,0.454,0.516,0.353,0.746
361,2021-22,Stetson,30,11,19,0.367,798,1772,544,1043,254,729,294,427,275,753,1028,443,188,89,355,429,2144,0.45,0.522,0.348,0.689
362,2020-21,Stetson,27,12,15,0.444,691,1545,493,972,198,573,316,454,242,678,920,394,154,86,341,411,1896,0.447,0.507,0.346,0.696
363,2019-20,Stetson,33,16,17,0.485,750,1808,458,943,292,865,375,545,318,716,1034,457,188,102,385,561,2167,0.415,0.486,0.338,0.688
364,2023-24,Stephen F. Austin,33,18,15,0.545,759,1792,512,1127,247,665,588,816,336,749,1085,413,260,122,563,690,2353,0.424,0.454,0.371,0.721
365,2022-23,Stephen F. Austin,32,19,13,0.594,764,1740,550,1095,214,645,496,714,341,726,1067,459,197,108,578,670,2238,0.439,0.502,0.332,0.695
366,2021-22,Stephen F. Austin,32,22,10,0.688,756,1764,539,1093,217,671,461,645,342,702,1044,401,230,114,575,614,2190,0.429,0.493,0.323,0.715
367,2020-21,Stephen F. Austin,21,16,5,0.762,500,1134,364,729,136,405,348,466,186,417,603,272,160,67,381,428,1484,0.441,0.499,0.336,0.747
368,2019-20,Stephen F. Austin,31,28,3,0.903,675,1594,465,981,210,613,517,713,273,657,930,356,237,109,669,675,2077,0.423,0.474,0.343,0.725
369,2023-24,Stanford,32,14,18,0.438,913,2020,642,1261,271,759,350,511,319,821,1140,420,222,88,358,529,2447,0.452,0.509,0.357,0.685
370,2022-23,Stanford,33,14,19,0.424,806,1819,543,1077,263,742,381,521,285,756,1041,415,196,90,400,535,2256,0.443,0.504,0.354,0.731
371,2021-22,Stanford,32,16,16,0.5,806,1791,577,1091,229,700,357,519,241,722,963,395,230,117,352,530,2198,0.45,0.529,0.327,0.688
372,2020-21,Stanford,27,14,13,0.519,669,1609,454,969,215,640,326,435,280,625,905,342,189,97,388,494,1879,0.416,0.469,0.336,0.749
373,2019-20,Stanford,32,20,12,0.625,707,1765,512,1106,195,659,391,561,316,777,1093,322,203,126,497,561,2000,0.401,0.463,0.296,0.697
374,2023-24,St. Thomas,33,20,13,0.606,777,1738,552,1056,225,682,361,500,257,768,1025,382,161,79,395,532,2140,0.447,0.523,0.33,0.722
375,2022-23,St. Thomas,33,19,14,0.576,839,1845,617,1184,222,661,416,561,305,829,1134,390,140,118,390,563,2316,0.455,0.521,0.336,0.742
376,2021-22,St. Thomas,30,10,20,0.333,814,1661,557,988,257,673,375,515,213,848,1061,387,102,88,337,463,2260,0.49,0.564,0.382,0.728
377,2023-24,St. Mary's (CA),34,26,8,0.765,712,1797,545,1265,167,532,422,588,254,688,942,336,182,97,369,539,2013,0.396,0.431,0.314,0.718
378,2022-23,St. Mary's (CA),35,27,8,0.771,753,1806,562,1229,191,577,408,549,242,758,1000,280,166,128,436,596,2105,0.417,0.457,0.331,0.743
379,2021-22,St. Mary's (CA),34,26,8,0.765,779,1826,604,1310,175,516,328,455,242,760,1002,290,204,104,429,504,2061,0.427,0.461,0.339,0.721
380,2020-21,St. Mary's (CA),24,14,10,0.583,558,1300,434,948,124,352,263,364,174,586,760,214,125,84,290,378,1503,0.429,0.458,0.352,0.723
381,2019-20,St. Mary's (CA),34,26,8,0.765,851,1882,647,1279,204,603,370,517,254,776,1030,333,136,107,401,556,2276,0.452,0.506,0.338,0.716
382,2023-24,St. John's (NY),33,20,13,0.606,824,1904,585,1221,239,683,487,655,350,756,1106,444,209,109,426,522,2374,0.433,0.479,0.35,0.744
383,2022-23,St. John's (NY),33,18,15,0.545,885,2037,608,1235,277,802,434,603,339,839,1178,509,271,108,486,533,2481,0.434,0.492,0.345,0.72
384,2021-22,St. John's (NY),32,17,15,0.531,827,1950,572,1203,255,747,464,648,380,865,1245,418,196,130,509,536,2373,0.424,0.475,0.341,0.716
385,2020-21,St. John's (NY),27,16,11,0.593,756,1634,550,1031,206,603,354,520,287,736,1023,395,186,108,443,452,2072,0.463,0.533,0.342,0.681
386,2019-20,St. John's (NY),32,17,15,0.531,785,1892,532,1093,253,799,467,685,379,931,1310,452,167,140,537,552,2290,0.415,0.487,0.317,0.682
387,2022-23,St. Francis Brooklyn,30,14,16,0.467,749,1677,572,1223,177,454,359,516,311,742,1053,401,192,92,409,493,2034,0.447,0.468,0.39,0.696
388,2021-22,St. Francis Brooklyn,30,10,20,0.333,782,1701,611,1177,171,524,381,553,295,788,1083,391,188,116,393,442,2116,0.46,0.519,0.326,0.689
389,2020-21,St. Francis Brooklyn,19,9,10,0.474,520,1125,374,742,146,383,325,440,205,499,704,271,116,79,280,338,1511,0.462,0.504,0.381,0.739
390,2019-20,St. Francis Brooklyn,31,13,18,0.419,779,1790,571,1198,208,592,454,644,314,846,1160,365,175,95,430,518,2220,0.435,0.477,0.351,0.705
391,2023-24,St. Bonaventure,33,20,13,0.606,798,1799,553,1067,245,732,424,610,304,756,1060,463,165,97,426,529,2265,0.444,0.518,0.335,0.695
392,2022-23,St. Bonaventure,32,14,18,0.438,735,1713,541,1038,194,675,501,700,311,793,1104,414,191,88,418,508,2165,0.429,0.521,0.287,0.716
393,2021-22,St. Bonaventure,33,23,10,0.697,805,1881,521,1051,284,830,300,418,308,803,1111,477,170,90,419,491,2194,0.428,0.496,0.342,0.718
394,2020-21,St. Bonaventure,21,16,5,0.762,454,1166,300,664,154,502,221,334,219,489,708,258,103,67,263,328,1283,0.389,0.452,0.307,0.662
395,2019-20,St. Bonaventure,31,19,12,0.613,716,1716,460,937,256,779,385,563,284,748,1032,436,169,93,373,488,2073,0.417,0.491,0.329,0.684
396,2023-24,Southern Utah,31,10,21,0.323,904,1894,726,1372,178,522,420,590,349,809,1158,420,213,107,388,599,2406,0.477,0.529,0.341,0.712
397,2022-23,Southern Utah,37,24,13,0.649,999,2270,711,1441,288,829,478,675,344,948,1292,473,252,128,527,760,2764,0.44,0.493,0.347,0.708
398,2021-22,Southern Utah,35,23,12,0.657,912,2076,637,1266,275,810,439,584,272,878,1150,431,207,117,429,617,2538,0.439,0.503,0.34,0.752
399,2020-21,Southern Utah,24,20,4,0.833,607,1428,425,873,182,555,273,409,190,567,757,311,119,70,329,476,1669,0.425,0.487,0.328,0.667
400,2019-20,Southern Utah,32,17,15,0.531,728,1832,535,1198,193,634,473,663,259,763,1022,362,182,126,402,594,2122,0.397,0.447,0.304,0.713
401,2023-24,Southern Mississippi,32,16,16,0.5,814,1889,588,1226,226,663,419,614,349,823,1172,386,260,87,392,554,2273,0.431,0.48,0.341,0.682
402,2022-23,Southern Mississippi,33,25,8,0.758,778,1874,553,1165,225,709,401,566,343,776,1119,408,221,83,481,550,2182,0.415,0.475,0.317,0.708
403,2021-22,Southern Mississippi,33,7,26,0.212,887,1955,573,1118,314,837,383,541,324,875,1199,506,228,94,379,492,2471,0.454,0.513,0.375,0.708
404,2020-21,Southern Mississippi,25,8,17,0.32,590,1395,383,775,207,620,281,403,206,646,852,311,176,55,336,382,1668,0.423,0.494,0.334,0.697
405,2019-20,Southern Mississippi,31,9,22,0.29,763,1780,481,938,282,842,434,585,294,757,1051,409,230,77,386,462,2242,0.429,0.513,0.335,0.742
406,2023-24,Southern Indiana,32,8,24,0.25,757,1781,542,1124,215,657,606,826,319,835,1154,385,213,105,384,597,2335,0.425,0.482,0.327,0.734
407,2022-23,Southern Indiana,33,16,17,0.485,829,1903,566,1142,263,761,526,731,310,834,1144,402,204,133,418,602,2447,0.436,0.496,0.346,0.72
408,2023-24,Southern Illinois,32,19,13,0.594,789,1747,626,1210,163,537,442,624,266,757,1023,350,187,115,346,563,2183,0.452,0.517,0.304,0.708
409,2022-23,Southern Illinois,33,23,10,0.697,743,1769,542,1160,201,609,339,521,299,768,1067,365,208,95,428,527,2026,0.42,0.467,0.33,0.651
410,2021-22,Southern Illinois,31,16,15,0.516,705,1590,541,1081,164,509,328,437,214,743,957,328,178,103,362,455,1902,0.443,0.5,0.322,0.751
411,2020-21,Southern Illinois,26,12,14,0.462,662,1447,462,859,200,588,246,342,208,681,889,377,166,83,328,399,1770,0.457,0.538,0.34,0.719
412,2019-20,Southern Illinois,32,16,16,0.5,751,1751,559,1141,192,610,297,429,322,806,1128,401,205,107,435,518,1991,0.429,0.49,0.315,0.692
413,2023-24,Southern California,33,15,18,0.455,855,1981,575,1213,280,768,462,626,377,812,1189,509,227,115,438,569,2452,0.432,0.474,0.365,0.738
414,2022-23,Southern California,33,22,11,0.667,776,1977,531,1244,245,733,427,598,415,766,1181,433,224,98,406,576,2224,0.393,0.427,0.334,0.714
415,2021-22,Southern California,34,26,8,0.765,806,2067,571,1357,235,710,396,554,352,793,1145,404,224,114,333,586,2243,0.39,0.421,0.331,0.715
416,2020-21,Southern California,33,25,8,0.758,780,2000,546,1298,234,702,354,482,344,732,1076,420,185,91,382,618,2148,0.39,0.421,0.333,0.734
417,2019-20,Southern California,31,22,9,0.71,723,1881,491,1140,232,741,368,527,333,755,1088,369,245,91,398,575,2046,0.384,0.431,0.313,0.698
418,2023-24,Southern,32,18,14,0.563,729,1676,536,1070,193,606,547,764,291,773,1064,402,215,98,528,556,2198,0.435,0.501,0.318,0.716
419,2022-23,Southern,32,15,17,0.469,766,1741,527,1019,239,722,509,731,296,840,1136,457,211,124,552,560,2280,0.44,0.517,0.331,0.696
420,2021-22,Southern,31,17,14,0.548,713,1611,544,1031,169,580,510,720,297,773,1070,355,205,120,588,582,2105,0.443,0.528,0.291,0.708
421,2020-21,Southern,19,8,11,0.421,457,1088,342,740,115,348,306,444,176,475,651,216,145,79,291,353,1335,0.42,0.462,0.33,0.689
422,2019-20,Southern,32,17,15,0.531,717,1647,549,1115,168,532,545,801,255,739,994,308,186,108,461,592,2147,0.435,0.492,0.316,0.68
423,2023-24,Southeastern Louisiana,32,15,17,0.469,800,1848,535,1025,265,823,406,557,337,737,1074,484,227,98,382,528,2271,0.433,0.522,0.322,0.729
424,2022-23,Southeastern Louisiana,32,18,14,0.563,861,1872,566,1100,295,772,415,603,327,808,1135,472,193,87,465,550,2432,0.46,0.515,0.382,0.688
425,2021-22,Southeastern Louisiana,34,19,15,0.559,992,2131,716,1315,276,816,383,543,386,850,1236,475,256,93,507,638,2643,0.466,0.544,0.338,0.705
426,2020-21,Southeastern Louisiana,26,8,18,0.308,700,1452,496,882,204,570,415,552,246,694,940,404,174,85,417,562,2019,0.482,0.562,0.358,0.752
427,2019-20,Southeastern Louisiana,31,8,23,0.258,845,1772,638,1141,207,631,532,712,339,835,1174,477,228,99,541,578,2429,0.477,0.559,0.328,0.747
428,2023-24,Southeast Missouri State,31,9,22,0.29,802,1733,642,1211,160,522,514,736,275,845,1120,387,206,104,392,508,2278,0.463,0.53,0.307,0.698
429,2022-23,Southeast Missouri State,36,19,17,0.528,928,2085,672,1341,256,744,622,899,343,962,1305,470,247,99,527,716,2734,0.445,0.501,0.344,0.692
430,2021-22,Southeast Missouri State,32,14,18,0.438,846,1868,605,1171,241,697,540,738,312,837,1149,419,211,89,432,620,2473,0.453,0.517,0.346,0.732
431,2020-21,Southeast Missouri State,27,11,16,0.407,672,1478,481,950,191,528,401,575,214,676,890,368,185,90,377,512,1936,0.455,0.506,0.362,0.697
432,2019-20,Southeast Missouri State,31,7,24,0.226,830,1757,593,1107,237,650,410,590,287,834,1121,468,171,102,389,563,2307,0.472,0.536,0.365,0.695
433,2023-24,South Florida,33,25,8,0.758,806,1924,576,1194,230,730,446,665,378,835,1213,408,204,98,420,611,2288,0.419,0.482,0.315,0.671
434,2022-23,South Florida,32,14,18,0.438,783,1818,538,1116,245,702,492,675,314,773,1087,430,219,97,418,536,2303,0.431,0.482,0.349,0.729
435,2021-22,South Florida,31,8,23,0.258,689,1669,454,974,235,695,399,560,280,832,1112,410,175,115,386,477,2012,0.413,0.466,0.338,0.713
436,2020-21,South Florida,22,9,13,0.409,553,1238,374,719,179,519,286,402,190,553,743,330,143,86,265,398,1571,0.447,0.52,0.345,0.711
437,2019-20,South Florida,31,14,17,0.452,686,1548,479,928,207,620,365,534,235,734,969,350,205,99,475,552,1944,0.443,0.516,0.334,0.684
438,2023-24,South Dakota State,35,22,13,0.629,876,2079,535,1101,341,978,397,534,310,863,1173,434,238,101,395,602,2490,0.421,0.486,0.349,0.743
439,2022-23,South Dakota State,32,19,13,0.594,826,1880,572,1112,254,768,327,431,276,816,1092,408,202,101,381,532,2233,0.439,0.514,0.331,0.759
440,2021-22,South Dakota State,35,30,5,0.857,954,2184,637,1287,317,897,336,454,297,815,1112,425,172,90,411,625,2561,0.437,0.495,0.353,0.74
441,2020-21,South Dakota State,23,16,7,0.696,606,1390,411,833,195,557,283,357,161,553,714,296,146,69,252,438,1690,0.436,0.493,0.35,0.793
442,2019-20,South Dakota State,32,22,10,0.688,840,1997,609,1242,231,755,345,508,339,743,1082,369,211,102,357,590,2256,0.421,0.49,0.306,0.679
443,2023-24,South Dakota,32,12,20,0.375,930,2063,644,1267,286,796,389,536,330,772,1102,435,212,108,281,547,2535,0.451,0.508,0.359,0.726
444,2022-23,South Dakota,31,12,19,0.387,813,1800,557,1082,256,718,400,547,283,777,1060,381,196,115,305,506,2282,0.452,0.515,0.357,0.731
445,2021-22,South Dakota,31,19,12,0.613,777,1716,546,1078,231,638,413,572,215,733,948,297,141,72,342,589,2198,0.453,0.506,0.362,0.722
446,2020-21,South Dakota,25,14,11,0.56,616,1465,414,885,202,580,371,504,218,636,854,262,117,58,277,467,1805,0.42,0.468,0.348,0.736
447,2019-20,South Dakota,32,20,12,0.625,853,1884,618,1226,235,658,433,587,237,789,1026,362,167,79,364,654,2374,0.453,0.504,0.357,0.738
448,2023-24,South Carolina State,32,14,18,0.438,778,1719,559,1075,219,644,615,827,318,757,1075,443,262,120,487,590,2390,0.453,0.52,0.34,0.744
449,2022-23,South Carolina State,31,5,26,0.161,890,1785,631,1133,259,652,560,777,343,809,1152,521,233,132,485,536,2599,0.499,0.557,0.397,0.721
450,2021-22,South Carolina State,31,15,16,0.484,767,1816,524,1097,243,719,472,679,306,849,1155,420,216,120,474,552,2249,0.422,0.478,0.338,0.695
451,2020-21,South Carolina State,18,1,17,0.056,504,1030,370,654,134,376,272,371,195,504,699,279,135,60,295,298,1414,0.489,0.566,0.356,0.733
452,2019-20,South Carolina State,29,11,18,0.379,782,1682,577,1083,205,599,411,613,276,691,967,354,158,99,358,553,2180,0.465,0.533,0.342,0.67
453,2023-24,South Carolina,34,26,8,0.765,825,1913,622,1314,203,599,444,605,318,793,1111,393,198,157,332,555,2297,0.431,0.473,0.339,0.734
454,2022-23,South Carolina,32,11,21,0.344,864,1858,636,1184,228,674,368,546,343,779,1122,470,234,112,336,478,2324,0.465,0.537,0.338,0.674
455,2021-22,South Carolina,31,18,13,0.581,735,1783,531,1145,204,638,504,719,356,769,1125,408,257,105,480,552,2178,0.412,0.464,0.32,0.701
456,2020-21,South Carolina,21,6,15,0.286,566,1222,399,768,167,454,363,477,219,577,796,310,162,93,348,369,1662,0.463,0.52,0.368,0.761
457,2019-20,South Carolina,31,18,13,0.581,656,1669,459,1004,197,665,647,886,315,783,1098,356,191,112,482,638,2156,0.393,0.457,0.296,0.73
458,2023-24,South Alabama,32,16,16,0.5,874,1948,654,1254,220,694,453,655,369,869,1238,385,223,133,388,514,2421,0.449,0.522,0.317,0.692
459,2022-23,South Alabama,35,19,16,0.543,853,2032,682,1451,171,581,405,565,346,907,1253,350,185,102,384,452,2282,0.42,0.47,0.294,0.717
460,2021-22,South Alabama,33,21,12,0.636,747,1846,520,1129,227,717,390,547,358,787,1145,397,186,81,486,559,2111,0.405,0.461,0.317,0.713
461,2020-21,South Alabama,28,17,11,0.607,700,1706,408,826,292,880,293,394,342,720,1062,413,168,111,388,451,1985,0.41,0.494,0.332,0.744
462,2019-20,South Alabama,31,20,11,0.645,747,1764,468,950,279,814,319,459,328,718,1046,422,165,115,431,544,2092,0.423,0.493,0.343,0.695
463,2023-24,SMU,33,20,13,0.606,793,1921,571,1220,222,701,463,647,378,768,1146,448,239,168,428,501,2271,0.413,0.468,0.317,0.716
464,2022-23,SMU,32,10,22,0.313,864,1908,617,1200,247,708,443,625,343,858,1201,495,225,152,428,561,2418,0.453,0.514,0.349,0.709
465,2021-22,SMU,33,24,9,0.727,819,2074,609,1369,210,705,367,527,400,823,1223,432,233,134,390,579,2215,0.395,0.445,0.298,0.696
466,2020-21,SMU,17,11,6,0.647,395,976,261,595,134,381,234,344,185,409,594,237,121,68,243,309,1158,0.405,0.439,0.352,0.68
467,2019-20,SMU,30,19,11,0.633,720,1723,465,982,255,741,359,486,309,664,973,429,212,90,377,514,2054,0.418,0.474,0.344,0.739
468,2023-24,SIU Edwardsville,33,17,16,0.515,798,1829,549,1139,249,690,469,655,321,829,1150,421,187,121,407,548,2314,0.436,0.482,0.361,0.716
469,2022-23,SIU Edwardsville,33,19,14,0.576,823,1936,588,1237,235,699,472,646,357,814,1171,390,197,91,452,633,2353,0.425,0.475,0.336,0.731
470,2021-22,SIU Edwardsville,32,11,21,0.344,760,1840,525,1101,235,739,483,665,336,794,1130,439,244,112,441,567,2238,0.413,0.477,0.318,0.726
471,2020-21,SIU Edwardsville,26,9,17,0.346,680,1504,485,926,195,578,342,501,281,628,909,401,207,60,357,450,1897,0.452,0.524,0.337,0.683
472,2019-20,SIU Edwardsville,31,8,23,0.258,759,1738,523,1022,236,716,507,694,316,790,1106,468,192,99,416,520,2261,0.437,0.512,0.33,0.731
473,2023-24,Siena,32,4,28,0.125,880,1922,649,1266,231,656,391,538,344,756,1100,441,291,107,318,515,2382,0.458,0.513,0.352,0.727
474,2022-23,Siena,32,17,15,0.531,793,1765,627,1270,166,495,399,582,284,735,1019,341,244,101,398,555,2151,0.449,0.494,0.335,0.686
475,2021-22,Siena,29,15,14,0.517,745,1689,577,1184,168,505,348,493,285,740,1025,330,210,90,342,457,2006,0.441,0.487,0.333,0.706
476,2020-21,Siena,17,12,5,0.706,400,979,300,670,100,309,171,242,164,391,555,166,107,46,200,310,1071,0.409,0.448,0.324,0.707
477,2019-20,Siena,30,20,10,0.667,745,1740,552,1134,193,606,348,468,270,684,954,336,172,110,350,539,2031,0.428,0.487,0.318,0.744
478,2023-24,Seton Hall,37,25,12,0.676,926,2193,619,1262,307,931,428,562,382,820,1202,526,273,163,450,603,2587,0.422,0.49,0.33,0.762
479,2022-23,Seton Hall,33,17,16,0.515,762,1835,547,1159,215,676,410,568,342,779,1121,415,233,144,475,598,2149,0.415,0.472,0.318,0.722
480,2021-22,Seton Hall,32,21,11,0.656,764,1899,564,1254,200,645,397,512,346,800,1146,369,204,133,405,524,2125,0.402,0.45,0.31,0.775
481,2020-21,Seton Hall,27,14,13,0.519,680,1576,482,1035,198,541,323,430,282,654,936,329,177,93,356,480,1881,0.431,0.466,0.366,0.751
482,2019-20,Seton Hall,30,21,9,0.7,717,1786,520,1170,197,616,406,579,351,748,1099,348,192,92,414,538,2037,0.401,0.444,0.32,0.701
483,2023-24,Seattle,37,23,14,0.622,871,2115,661,1395,210,720,519,741,333,877,1210,412,239,117,457,673,2471,0.412,0.474,0.292,0.7
484,2022-23,Seattle,32,20,12,0.625,791,1847,584,1204,207,643,420,600,284,841,1125,412,197,111,422,592,2209,0.428,0.485,0.322,0.7
485,2021-22,Seattle,32,23,9,0.719,727,1806,520,1146,207,660,471,700,297,890,1187,373,179,110,469,567,2132,0.403,0.454,0.314,0.673
486,2020-21,Seattle,23,12,11,0.522,531,1265,380,807,151,458,365,490,230,637,867,282,118,66,362,439,1578,0.42,0.471,0.33,0.745
487,2019-20,Seattle,29,14,15,0.483,713,1682,524,1085,189,597,495,673,276,798,1074,354,153,89,396,598,2110,0.424,0.483,0.317,0.736
488,2023-24,Santa Clara,33,20,13,0.606,843,1984,613,1251,230,733,468,662,314,751,1065,411,231,83,337,585,2384,0.425,0.49,0.314,0.707
489,2022-23,Santa Clara,33,23,10,0.697,883,2035,602,1250,281,785,366,501,287,819,1106,446,211,88,392,582,2413,0.434,0.482,0.358,0.731
490,2021-22,Santa Clara,33,21,12,0.636,898,2097,660,1413,238,684,339,445,321,833,1154,446,181,104,389,541,2373,0.428,0.467,0.348,0.762
491,2020-21,Santa Clara,20,12,8,0.6,503,1212,361,773,142,439,264,362,180,543,723,262,121,55,246,430,1412,0.415,0.467,0.323,0.729
492,2019-20,Santa Clara,33,20,13,0.606,817,1925,605,1289,212,636,519,724,312,869,1181,408,214,95,460,605,2365,0.424,0.469,0.333,0.717
493,2023-24,San Jose State,32,9,23,0.281,854,1804,607,1166,247,638,448,642,307,840,1147,465,154,91,343,460,2403,0.473,0.521,0.387,0.698
494,2022-23,San Jose State,35,21,14,0.6,826,1970,586,1270,240,700,426,559,294,773,1067,419,180,91,291,518,2318,0.419,0.461,0.343,0.762
495,2021-22,San Jose State,31,8,23,0.258,839,1802,622,1190,217,612,347,484,303,819,1122,438,193,79,328,447,2242,0.466,0.523,0.355,0.717
496,2020-21,San Jose State,21,5,16,0.238,631,1398,458,845,173,553,273,380,275,666,941,328,135,76,215,356,1708,0.451,0.542,0.313,0.718
497,2019-20,San Jose State,31,7,24,0.226,916,1927,676,1257,240,670,451,651,331,929,1260,580,227,76,409,580,2523,0.475,0.538,0.358,0.693
498,2023-24,San Francisco,34,23,11,0.676,776,1814,545,1122,231,692,479,683,265,765,1030,377,186,69,473,508,2262,0.428,0.486,0.334,0.701
499,2022-23,San Francisco,34,20,14,0.588,854,1941,624,1266,230,675,558,726,311,802,1113,384,228,85,431,590,2496,0.44,0.493,0.341,0.769
500,2021-22,San Francisco,34,24,10,0.706,834,1957,659,1361,175,596,461,647,287,836,1123,364,208,99,440,589,2304,0.426,0.484,0.294,0.713
501,2020-21,San Francisco,25,11,14,0.44,605,1339,483,965,122,374,400,535,197,682,879,279,139,78,345,372,1732,0.452,0.501,0.326,0.748
502,2019-20,San Francisco,34,22,12,0.647,851,1911,642,1352,209,559,428,594,270,852,1122,361,205,97,442,572,2339,0.445,0.475,0.374,0.721
503,2023-24,San Diego State,37,26,11,0.703,857,2117,588,1250,269,867,484,681,377,868,1245,426,227,112,460,686,2467,0.405,0.47,0.31,0.711
504,2022-23,San Diego State,39,32,7,0.821,878,2146,635,1289,243,857,476,633,345,910,1255,413,243,116,503,697,2475,0.409,0.493,0.284,0.752
505,2021-22,San Diego State,32,23,9,0.719,654,1702,461,1059,193,643,359,528,303,753,1056,336,187,97,463,543,1860,0.384,0.435,0.3,0.68
506,2020-21,San Diego State,28,23,5,0.821,573,1461,348,791,225,670,342,465,224,671,895,349,127,81,421,513,1713,0.392,0.44,0.336,0.735
507,2019-20,San Diego State,32,30,2,0.938,659,1705,446,988,213,717,370,508,284,731,1015,352,175,61,452,559,1903,0.387,0.451,0.297,0.728
508,2023-24,San Diego,33,18,15,0.545,885,1941,624,1165,261,776,519,739,365,872,1237,551,247,116,439,551,2550,0.456,0.536,0.336,0.702
509,2022-23,San Diego,31,11,20,0.355,897,1818,588,1061,309,757,392,587,296,781,1077,540,168,93,399,546,2495,0.493,0.554,0.408,0.668
510,2021-22,San Diego,31,15,16,0.484,801,1831,636,1324,165,507,319,444,282,803,1085,391,184,88,348,501,2086,0.437,0.48,0.325,0.718
511,2020-21,San Diego,14,3,11,0.214,388,822,288,562,100,260,203,278,123,424,547,190,98,44,186,229,1079,0.472,0.512,0.385,0.73
512,2019-20,San Diego,32,9,23,0.281,850,1892,657,1284,193,608,426,597,295,834,1129,403,220,108,416,575,2319,0.449,0.512,0.317,0.714
513,2023-24,Samford,35,29,6,0.829,897,2068,619,1246,278,822,535,780,414,841,1255,485,273,135,583,667,2607,0.434,0.497,0.338,0.686
514,2022-23,Samford,32,21,11,0.656,770,1783,483,1001,287,782,463,654,296,770,1066,440,207,72,468,649,2290,0.432,0.483,0.367,0.708
515,2021-22,Samford,32,21,11,0.656,824,1868,532,1017,292,851,423,603,321,770,1091,488,243,72,434,532,2363,0.441,0.523,0.343,0.701
516,2020-21,Samford,19,6,13,0.316,501,1145,305,582,196,563,312,439,178,508,686,300,152,55,271,320,1510,0.438,0.524,0.348,0.711
517,2019-20,Samford,33,10,23,0.303,1000,2179,641,1190,359,989,352,519,411,877,1288,617,254,114,467,618,2711,0.459,0.539,0.363,0.678
518,2023-24,Sam Houston State,33,21,12,0.636,794,1862,564,1136,230,726,464,675,317,816,1133,411,231,132,445,592,2282,0.426,0.496,0.317,0.687
519,2022-23,Sam Houston State,34,26,8,0.765,667,1704,405,909,262,795,419,598,276,764,1040,374,193,102,564,554,2015,0.391,0.446,0.33,0.701
520,2021-22,Sam Houston State,33,19,14,0.576,710,1740,476,997,234,743,428,594,236,892,1128,399,193,83,485,522,2082,0.408,0.477,0.315,0.721
521,2020-21,Sam Houston State,28,19,9,0.679,680,1612,504,1008,176,604,433,615,315,729,1044,378,181,84,495,500,1969,0.422,0.5,0.291,0.704
522,2019-20,Sam Houston State,31,18,13,0.581,734,1747,500,1011,234,736,543,735,305,779,1084,395,218,99,572,575,2245,0.42,0.495,0.318,0.739
523,2023-24,Saint Peter's,33,19,14,0.576,707,1696,514,1106,193,590,506,723,327,779,1106,366,215,132,449,613,2113,0.417,0.465,0.327,0.7
524,2022-23,Saint Peter's,32,14,18,0.438,664,1551,475,994,189,557,566,789,294,743,1037,332,147,140,402,516,2083,0.428,0.478,0.339,0.717
525,2021-22,Saint Peter's,34,22,12,0.647,699,1811,507,1152,192,659,535,738,343,803,1146,370,233,166,467,613,2125,0.386,0.44,0.291,0.725
526,2020-21,Saint Peter's,25,14,11,0.56,511,1323,345,829,166,494,349,523,250,629,879,281,168,103,382,435,1537,0.386,0.416,0.336,0.667
527,2019-20,Saint Peter's,30,18,12,0.6,638,1583,455,1013,183,570,464,646,281,679,960,345,230,145,454,543,1923,0.403,0.449,0.321,0.718
528,2023-24,Saint Louis,33,13,20,0.394,906,1965,603,1135,303,830,505,697,332,823,1155,455,218,130,335,582,2620,0.461,0.531,0.365,0.725
529,2022-23,Saint Louis,33,21,12,0.636,819,1977,565,1223,254,754,456,633,327,783,1110,433,211,109,353,561,2348,0.414,0.462,0.337,0.72
530,2021-22,Saint Louis,35,23,12,0.657,850,2016,620,1303,230,713,446,659,339,790,1129,402,242,161,448,591,2376,0.422,0.476,0.323,0.677
531,2020-21,Saint Louis,21,14,7,0.667,467,1114,324,689,143,425,297,409,155,469,624,241,139,84,286,341,1374,0.419,0.47,0.336,0.726
532,2019-20,Saint Louis,31,23,8,0.742,685,1710,467,1035,218,675,432,619,276,747,1023,335,210,110,426,585,2020,0.401,0.451,0.323,0.698
533,2023-24,Saint Joseph's,35,21,14,0.6,873,2080,581,1196,292,884,431,598,371,858,1229,478,243,141,427,557,2469,0.42,0.486,0.33,0.721
534,2022-23,Saint Joseph's,33,16,17,0.485,834,1923,558,1113,276,810,445,630,355,840,1195,491,226,120,437,574,2389,0.434,0.501,0.341,0.706
535,2021-22,Saint Joseph's,30,11,19,0.367,774,1813,594,1247,180,566,344,488,266,789,1055,356,208,108,283,411,2072,0.427,0.476,0.318,0.705
536,2020-21,Saint Joseph's,20,5,15,0.25,602,1278,437,808,165,470,283,401,226,604,830,331,145,69,259,322,1652,0.471,0.541,0.351,0.706
537,2019-20,Saint Joseph's,32,6,26,0.188,920,1976,676,1319,244,657,459,633,324,927,1251,458,213,128,328,530,2543,0.466,0.513,0.371,0.725
538,2023-24,Saint Francis (PA),30,8,22,0.267,769,1685,547,1045,222,640,421,601,308,716,1024,400,209,124,356,497,2181,0.456,0.523,0.347,0.7
539,2022-23,Saint Francis (PA),31,13,18,0.419,843,1868,625,1208,218,660,382,552,304,758,1062,422,209,84,329,534,2286,0.451,0.517,0.33,0.692
540,2021-22,Saint Francis (PA),30,9,21,0.3,821,1829,571,1130,250,699,313,455,336,794,1130,446,206,106,387,494,2205,0.449,0.505,0.358,0.688
541,2020-21,Saint Francis (PA),22,6,16,0.273,591,1302,434,801,157,501,275,383,221,564,785,294,152,80,288,394,1614,0.454,0.542,0.313,0.718
542,2019-20,Saint Francis (PA),32,22,10,0.688,833,1883,583,1140,250,743,382,532,320,741,1061,423,181,110,438,584,2298,0.442,0.511,0.336,0.718
543,2023-24,Sacred Heart,32,16,16,0.5,821,1888,549,1117,272,771,399,591,382,805,1187,476,204,109,464,501,2313,0.435,0.491,0.353,0.675
544,2022-23,Sacred Heart,33,16,17,0.485,866,1973,620,1244,246,729,373,533,362,864,1226,461,245,101,463,501,2351,0.439,0.498,0.337,0.7
545,2021-22,Sacred Heart,30,10,20,0.333,850,1854,606,1151,244,703,310,469,324,723,1047,446,220,109,335,478,2254,0.458,0.526,0.347,0.661
546,2020-21,Sacred Heart,18,9,9,0.5,506,1119,384,748,122,371,216,309,210,466,676,233,106,74,191,325,1350,0.452,0.513,0.329,0.699
547,2019-20,Sacred Heart,33,20,13,0.606,862,2077,627,1372,235,705,332,482,361,767,1128,476,220,118,369,629,2291,0.415,0.457,0.333,0.689
548,2023-24,Sacramento State,34,10,24,0.294,859,1854,608,1134,251,720,425,593,264,727,991,447,253,102,350,574,2394,0.463,0.536,0.349,0.717
549,2022-23,Sacramento State,32,14,18,0.438,822,1801,629,1252,193,549,332,451,248,702,950,379,213,85,302,496,2169,0.456,0.502,0.352,0.736
550,2021-22,Sacramento State,29,11,18,0.379,729,1598,528,1014,201,584,376,523,258,781,1039,386,158,91,353,461,2035,0.456,0.521,0.344,0.719
551,2020-21,Sacramento State,20,8,12,0.4,527,1090,390,707,137,383,251,337,155,499,654,268,90,42,256,343,1442,0.483,0.552,0.358,0.745
552,2019-20,Sacramento State,30,16,14,0.533,629,1510,486,1064,143,446,390,512,240,689,929,306,161,85,423,499,1791,0.417,0.457,0.321,0.762
553,2023-24,Rutgers,32,15,17,0.469,733,1798,501,1089,232,709,431,616,363,904,1267,402,210,133,477,545,2129,0.408,0.46,0.327,0.7
554,2022-23,Rutgers,34,19,15,0.559,742,1855,497,1059,245,796,350,509,333,833,1166,417,200,133,492,543,2079,0.4,0.469,0.308,0.688
555,2021-22,Rutgers,32,18,14,0.563,756,1807,513,1090,243,717,374,516,300,779,1079,397,185,100,379,486,2129,0.418,0.471,0.339,0.725
556,2020-21,Rutgers,28,16,12,0.571,670,1612,485,1039,185,573,368,523,296,723,1019,377,190,92,362,450,1893,0.416,0.467,0.323,0.704
557,2019-20,Rutgers,31,20,11,0.645,681,1778,453,1045,228,733,352,494,300,762,1062,374,167,114,402,531,1942,0.383,0.433,0.311,0.713
558,2023-24,Robert Morris,32,10,22,0.313,860,1865,642,1221,218,644,487,672,301,767,1068,437,235,85,348,496,2425,0.461,0.526,0.339,0.725
559,2022-23,Robert Morris,33,16,17,0.485,793,1831,584,1240,209,591,410,561,309,801,1110,349,224,89,435,509,2205,0.433,0.471,0.354,0.731
560,2021-22,Robert Morris,32,8,24,0.25,874,1905,621,1208,253,697,389,538,352,719,1071,480,235,110,372,461,2390,0.459,0.514,0.363,0.723
561,2020-21,Robert Morris,19,4,15,0.211,527,1125,365,704,162,421,278,385,220,495,715,276,122,50,261,291,1494,0.468,0.518,0.385,0.722
562,2019-20,Robert Morris,34,20,14,0.588,824,1842,608,1171,216,671,416,573,322,837,1159,410,211,114,502,533,2280,0.447,0.519,0.322,0.726
563,2023-24,Rider,32,15,17,0.469,794,1878,549,1155,245,723,475,679,338,774,1112,412,243,109,368,536,2308,0.423,0.475,0.339,0.7
564,2022-23,Rider,30,16,14,0.533,690,1625,441,926,249,699,398,618,290,657,947,364,179,97,334,472,2027,0.425,0.476,0.356,0.644
565,2021-22,Rider,33,14,19,0.424,783,1884,497,1048,286,836,434,626,333,868,1201,430,198,126,422,539,2286,0.416,0.474,0.342,0.693
566,2020-21,Rider,23,6,17,0.261,601,1299,417,778,184,521,316,468,204,581,785,322,148,73,273,395,1702,0.463,0.536,0.353,0.675
567,2019-20,Rider,30,18,12,0.6,735,1749,486,982,249,767,361,530,259,744,1003,387,201,108,412,594,2080,0.42,0.495,0.325,0.681
568,2023-24,Richmond,33,23,10,0.697,783,1932,536,1146,247,786,375,514,324,900,1224,375,153,94,381,499,2188,0.405,0.468,0.314,0.73
569,2022-23,Richmond,33,15,18,0.455,813,1893,562,1131,251,762,360,496,286,851,1137,405,198,94,381,578,2237,0.429,0.497,0.329,0.726
570,2021-22,Richmond,37,24,13,0.649,951,2147,685,1372,266,775,364,502,346,970,1316,470,197,115,474,576,2532,0.443,0.499,0.343,0.725
571,2020-21,Richmond,23,14,9,0.609,592,1284,444,816,148,468,255,366,211,595,806,276,120,61,353,352,1587,0.461,0.544,0.316,0.697
572,2019-20,Richmond,31,24,7,0.774,740,1784,517,1052,223,732,367,539,300,800,1100,351,174,95,430,485,2070,0.415,0.491,0.305,0.681
573,2023-24,Rice,32,11,21,0.344,875,1941,594,1193,281,748,390,525,334,804,1138,475,233,110,328,500,2421,0.451,0.498,0.376,0.743
574,2022-23,Rice,35,19,16,0.543,1006,2161,712,1352,294,809,374,538,318,893,1211,463,242,90,417,607,2680,0.466,0.527,0.363,0.695
575,2021-22,Rice,33,16,17,0.485,936,2088,689,1345,247,743,302,425,331,804,1135,455,228,110,336,543,2421,0.448,0.512,0.332,0.711
576,2020-21,Rice,28,15,13,0.536,790,1767,573,1154,217,613,265,378,265,717,982,411,216,97,350,447,2062,0.447,0.497,0.354,0.701
577,2019-20,Rice,32,15,17,0.469,876,1928,627,1167,249,761,374,548,304,848,1152,443,197,94,402,566,2375,0.454,0.537,0.327,0.682
578,2023-24,Rhode Island,32,12,20,0.375,890,1967,613,1191,277,776,386,581,326,774,1100,474,224,149,289,590,2443,0.452,0.515,0.357,0.664
579,2022-23,Rhode Island,31,9,22,0.29,793,1822,590,1189,203,633,401,577,328,787,1115,406,213,165,370,558,2190,0.435,0.496,0.321,0.695
580,2021-22,Rhode Island,31,15,16,0.484,686,1749,451,1024,235,725,408,557,312,747,1059,395,229,90,407,557,2015,0.392,0.44,0.324,0.732
581,2020-21,Rhode Island,25,10,15,0.4,622,1494,436,931,186,563,347,500,247,630,877,341,173,95,314,475,1777,0.416,0.468,0.33,0.694
582,2019-20,Rhode Island,30,21,9,0.7,752,1799,551,1122,201,677,361,512,321,820,1141,397,165,100,452,571,2066,0.418,0.491,0.297,0.705
583,2023-24,Radford,33,16,17,0.485,845,1946,598,1165,247,781,424,602,401,757,1158,394,160,86,346,501,2361,0.434,0.513,0.316,0.704
584,2022-23,Radford,36,21,15,0.583,849,1889,616,1188,233,701,401,587,316,812,1128,404,201,96,483,585,2332,0.449,0.519,0.332,0.683
585,2021-22,Radford,29,11,18,0.379,681,1497,486,937,195,560,398,551,230,723,953,331,204,95,391,473,1955,0.455,0.519,0.348,0.722
586,2020-21,Radford,27,15,12,0.556,628,1501,406,898,222,603,267,366,224,565,789,311,169,72,330,513,1745,0.418,0.452,0.368,0.73
587,2019-20,Radford,32,21,11,0.656,734,1749,477,960,257,789,390,579,290,740,1030,396,134,93,354,571,2115,0.42,0.497,0.326,0.674
588,2023-24,Quinnipiac,34,24,10,0.706,874,2074,617,1306,257,768,417,591,338,799,1137,448,230,137,440,532,2422,0.421,0.472,0.335,0.706
589,2022-23,Quinnipiac,32,20,12,0.625,822,1941,597,1231,225,710,362,517,320,772,1092,392,208,129,377,550,2231,0.423,0.485,0.317,0.7
590,2021-22,Quinnipiac,31,14,17,0.452,803,1852,551,1160,252,692,358,498,308,759,1067,384,215,118,377,460,2216,0.434,0.475,0.364,0.719
591,2020-21,Quinnipiac,22,9,13,0.409,531,1362,390,893,141,469,315,445,240,633,873,270,158,87,277,403,1518,0.39,0.437,0.301,0.708
592,2019-20,Quinnipiac,30,15,15,0.5,793,1868,557,1199,236,669,300,440,289,751,1040,435,202,96,291,480,2122,0.425,0.465,0.353,0.682
593,2023-24,Queens (NC),33,14,19,0.424,985,2096,716,1306,269,790,454,617,342,900,1242,411,212,152,384,594,2693,0.47,0.548,0.341,0.736
594,2022-23,Queens (NC),33,18,15,0.545,924,2015,671,1285,253,730,362,506,293,821,1114,443,211,132,372,577,2463,0.459,0.522,0.347,0.715
595,2023-24,Purdue Fort Wayne,36,23,13,0.639,930,2080,685,1310,245,770,472,665,351,979,1330,469,201,107,581,588,2577,0.447,0.523,0.318,0.71
596,2022-23,Purdue Fort Wayne,32,17,15,0.531,847,1909,619,1155,228,754,312,433,274,833,1107,395,212,104,414,517,2234,0.444,0.536,0.302,0.721
597,2021-22,Purdue Fort Wayne,33,21,12,0.636,847,1856,585,1112,262,744,342,473,278,822,1100,433,204,95,519,540,2298,0.456,0.526,0.352,0.723
598,2020-21,Purdue Fort Wayne,23,8,15,0.348,650,1416,463,859,187,557,322,431,242,499,741,325,179,54,282,364,1809,0.459,0.539,0.336,0.747
599,2019-20,Purdue Fort Wayne,33,14,19,0.424,836,1856,567,1076,269,780,379,532,251,853,1104,449,206,98,435,502,2320,0.45,0.527,0.345,0.712
600,2023-24,Purdue,39,34,5,0.872,1011,2423,730,1530,281,893,386,534,353,788,1141,555,263,96,368,792,2691,0.417,0.477,0.315,0.723
601,2022-23,Purdue,35,29,6,0.829,842,2024,617,1307,225,717,287,389,284,691,975,432,215,103,348,660,2196,0.416,0.472,0.314,0.738
602,2021-22,Purdue,37,29,8,0.784,943,2225,643,1322,300,903,346,480,318,758,1076,503,220,90,351,716,2532,0.424,0.486,0.332,0.721
603,2020-21,Purdue,28,18,10,0.643,657,1579,429,863,228,716,324,476,235,645,880,394,155,96,315,515,1868,0.416,0.497,0.318,0.681
604,2019-20,Purdue,31,16,15,0.516,676,1661,463,963,213,698,377,530,280,735,1015,401,161,116,419,510,1942,0.407,0.481,0.305,0.711
605,2023-24,Providence,35,21,14,0.6,872,2094,627,1379,245,715,418,580,360,870,1230,381,236,102,411,607,2407,0.416,0.455,0.343,0.721
606,2022-23,Providence,33,21,12,0.636,872,1980,647,1315,225,665,374,502,320,749,1069,419,199,130,387,597,2343,0.44,0.492,0.338,0.745
607,2021-22,Providence,33,27,6,0.818,802,1960,590,1253,212,707,368,529,337,799,1136,369,193,122,345,603,2184,0.409,0.471,0.3,0.696
608,2020-21,Providence,26,13,13,0.5,668,1533,514,1015,154,518,323,462,278,669,947,326,165,87,299,459,1813,0.436,0.506,0.297,0.699
609,2019-20,Providence,31,19,12,0.613,705,1691,511,1067,194,624,447,632,304,797,1101,362,216,105,464,584,2051,0.417,0.479,0.311,0.707
610,2023-24,Princeton,29,24,5,0.828,718,1616,513,987,205,629,291,403,223,705,928,349,135,80,321,467,1932,0.444,0.52,0.326,0.722
611,2022-23,Princeton,32,23,9,0.719,810,1904,606,1271,204,633,368,534,263,792,1055,354,196,106,336,572,2192,0.425,0.477,0.322,0.689
612,2021-22,Princeton,30,23,7,0.767,814,1793,626,1223,188,570,287,398,239,769,1008,323,166,90,346,436,2103,0.454,0.512,0.33,0.721
613,2019-20,Princeton,27,14,13,0.519,703,1515,544,1053,159,462,301,400,202,635,837,296,168,92,318,441,1866,0.464,0.517,0.344,0.753
614,2023-24,Presbyterian,33,14,19,0.424,825,1801,604,1169,221,632,542,749,298,817,1115,381,195,116,426,611,2413,0.458,0.517,0.35,0.724
615,2022-23,Presbyterian,32,5,27,0.156,786,1686,564,1094,222,592,429,655,295,757,1052,374,222,129,396,555,2223,0.466,0.516,0.375,0.655
616,2021-22,Presbyterian,32,12,20,0.375,737,1643,509,1030,228,613,472,651,242,764,1006,385,217,105,489,551,2174,0.449,0.494,0.372,0.725
617,2020-21,Presbyterian,22,7,15,0.318,506,1106,368,707,138,399,326,465,184,519,703,254,156,81,331,411,1476,0.458,0.521,0.346,0.701
618,2019-20,Presbyterian,32,10,22,0.313,803,1780,514,983,289,797,451,639,294,771,1065,437,228,106,373,531,2346,0.451,0.523,0.363,0.706
619,2023-24,Prairie View A&M,31,10,21,0.323,808,1708,613,1147,195,561,557,792,332,823,1155,400,211,127,516,597,2368,0.473,0.534,0.348,0.703
620,2022-23,Prairie View A&M,32,13,19,0.406,742,1723,545,1144,197,579,515,718,285,794,1079,359,184,132,494,575,2196,0.431,0.476,0.34,0.717
621,2021-22,Prairie View A&M,27,8,19,0.296,698,1563,500,1009,198,554,467,701,337,641,978,343,236,107,404,507,2061,0.447,0.496,0.357,0.666
622,2020-21,Prairie View A&M,21,16,5,0.762,461,1097,344,729,117,368,310,505,231,526,757,230,144,66,382,323,1349,0.42,0.472,0.318,0.614
623,2019-20,Prairie View A&M,32,19,13,0.594,716,1673,527,1039,189,634,565,818,285,781,1066,382,188,101,567,652,2186,0.428,0.507,0.298,0.691
624,2023-24,Portland State,32,17,15,0.531,818,1841,571,1140,247,701,416,604,314,868,1182,448,184,119,419,555,2299,0.444,0.501,0.352,0.689
625,2022-23,Portland State,31,12,19,0.387,787,1669,585,1103,202,566,564,760,292,821,1113,425,159,69,495,593,2340,0.472,0.53,0.357,0.742
626,2021-22,Portland State,31,14,17,0.452,771,1733,540,1080,231,653,464,672,332,846,1178,377,185,98,535,581,2237,0.445,0.5,0.354,0.69
627,2020-21,Portland State,22,9,13,0.409,498,1140,359,757,139,383,328,475,163,599,762,273,125,64,360,418,1463,0.437,0.474,0.363,0.691
628,2019-20,Portland State,32,18,14,0.563,897,1910,701,1327,196,583,422,587,365,774,1139,498,183,112,489,558,2412,0.47,0.528,0.336,0.719
629,2023-24,Portland,33,12,21,0.364,970,2089,616,1156,354,933,328,461,323,870,1193,558,205,87,301,581,2622,0.464,0.533,0.379,0.711
630,2022-23,Portland,33,14,19,0.424,932,2045,595,1154,337,891,393,573,349,820,1169,474,206,60,403,707,2594,0.456,0.516,0.378,0.686
631,2021-22,Portland,34,19,15,0.559,885,2108,597,1256,288,852,396,538,331,890,1221,418,209,86,425,702,2454,0.42,0.475,0.338,0.736
632,2020-21,Portland,21,6,15,0.286,661,1315,457,771,204,544,222,298,213,601,814,405,137,91,299,402,1748,0.503,0.593,0.375,0.745
633,2019-20,Portland,32,9,23,0.281,834,1921,570,1140,264,781,377,570,344,867,1211,498,230,83,427,595,2309,0.434,0.5,0.338,0.661
634,2023-24,Pittsburgh,33,22,11,0.667,793,1841,574,1130,219,711,427,562,264,836,1100,408,165,115,366,555,2232,0.431,0.508,0.308,0.76
635,2022-23,Pittsburgh,36,24,12,0.667,892,2122,619,1286,273,836,453,645,376,870,1246,479,182,119,406,647,2510,0.42,0.481,0.327,0.702
636,2021-22,Pittsburgh,32,11,21,0.344,769,1744,493,995,276,749,364,513,271,724,995,464,211,99,340,550,2178,0.441,0.495,0.368,0.71
637,2020-21,Pittsburgh,22,10,12,0.455,543,1249,380,744,163,505,294,415,199,530,729,348,130,93,263,386,1543,0.435,0.511,0.323,0.708
638,2019-20,Pittsburgh,33,16,17,0.485,791,1838,544,1110,247,728,340,477,387,812,1199,467,180,140,510,599,2169,0.43,0.49,0.339,0.713
639,2023-24,Pepperdine,33,13,20,0.394,889,1850,670,1273,219,577,446,617,265,815,1080,442,200,77,381,597,2443,0.481,0.526,0.38,0.723
640,2022-23,Pepperdine,31,9,22,0.29,915,1991,672,1315,243,676,447,638,341,808,1149,439,224,67,378,519,2520,0.46,0.511,0.359,0.701
641,2021-22,Pepperdine,32,7,25,0.219,906,1953,669,1235,237,718,431,604,346,870,1216,496,237,85,421,545,2480,0.464,0.542,0.33,0.714
642,2020-21,Pepperdine,27,15,12,0.556,707,1616,536,1008,171,608,403,549,257,691,948,373,180,53,366,518,1988,0.438,0.532,0.281,0.734
643,2019-20,Pepperdine,32,16,16,0.5,867,1891,604,1201,263,690,469,656,307,845,1152,499,211,85,442,630,2466,0.458,0.503,0.381,0.715
644,2023-24,Pennsylvania,29,11,18,0.379,782,1721,514,973,268,748,325,458,268,707,975,439,171,89,289,431,2157,0.454,0.528,0.358,0.71
645,2022-23,Pennsylvania,30,17,13,0.567,757,1811,497,1011,260,800,386,564,315,699,1014,395,194,88,309,452,2160,0.418,0.492,0.325,0.684
646,2021-22,Pennsylvania,28,12,16,0.429,771,1695,547,1049,224,646,347,489,279,733,1012,341,164,89,299,408,2113,0.455,0.521,0.347,0.71
647,2019-20,Pennsylvania,27,16,11,0.593,716,1704,541,1181,175,523,299,418,283,738,1021,286,195,80,324,409,1906,0.42,0.458,0.335,0.715
648,2023-24,Penn State,33,16,17,0.485,854,1888,666,1268,188,620,526,686,355,863,1218,484,193,104,484,582,2422,0.452,0.525,0.303,0.767
649,2022-23,Penn State,37,23,14,0.622,933,2171,666,1355,267,816,391,554,336,957,1293,514,173,105,317,500,2524,0.43,0.492,0.327,0.706
650,2021-22,Penn State,31,14,17,0.452,725,1741,493,1081,232,660,333,457,256,716,972,400,186,98,271,441,2015,0.416,0.456,0.352,0.729
651,2020-21,Penn State,25,11,14,0.44,649,1398,464,861,185,537,342,469,200,651,851,363,139,106,347,432,1825,0.464,0.539,0.345,0.729
652,2019-20,Penn State,31,21,10,0.677,758,1846,561,1242,197,604,401,587,323,841,1164,374,169,100,411,558,2114,0.411,0.452,0.326,0.683
653,2023-24,Pacific,32,6,26,0.188,903,1867,642,1128,261,739,486,665,324,889,1213,463,199,105,369,588,2553,0.484,0.569,0.353,0.731
654,2022-23,Pacific,33,15,18,0.455,906,1937,631,1157,275,780,478,704,345,874,1219,447,180,103,428,598,2565,0.468,0.545,0.353,0.679
655,2021-22,Pacific,30,8,22,0.267,777,1693,502,980,275,713,353,461,211,823,1034,383,168,69,393,507,2182,0.459,0.512,0.386,0.766
656,2020-21,Pacific,18,9,9,0.5,444,1017,299,593,145,424,239,328,134,448,582,223,83,52,230,308,1272,0.437,0.504,0.342,0.729
657,2019-20,Pacific,33,23,10,0.697,711,1710,502,1093,209,617,497,704,209,715,924,294,175,83,405,610,2128,0.416,0.459,0.339,0.706
658,2023-24,Oregon State,32,13,19,0.406,816,1832,585,1133,231,699,463,651,341,751,1092,453,204,96,371,597,2326,0.445,0.516,0.33,0.711
659,2022-23,Oregon State,32,11,21,0.344,745,1743,520,1078,225,665,429,593,320,755,1075,432,208,103,377,531,2144,0.427,0.482,0.338,0.723
660,2021-22,Oregon State,31,3,28,0.097,886,1851,621,1112,265,739,385,538,347,788,1135,467,209,93,374,507,2422,0.479,0.558,0.359,0.716
661,2020-21,Oregon State,33,20,13,0.606,763,1806,553,1107,210,699,496,687,328,782,1110,414,175,92,400,600,2232,0.422,0.5,0.3,0.722
662,2019-20,Oregon State,31,18,13,0.581,744,1727,526,1099,218,628,391,533,304,731,1035,408,173,95,383,580,2097,0.431,0.479,0.347,0.734
663,2023-24,Oregon,36,24,12,0.667,928,2059,663,1301,265,758,481,665,330,891,1221,471,191,127,442,631,2602,0.451,0.51,0.35,0.723
664,2022-23,Oregon,36,21,15,0.583,866,2119,601,1332,265,787,389,507,343,822,1165,441,219,89,395,627,2386,0.409,0.451,0.337,0.767
665,2021-22,Oregon,35,20,15,0.571,886,2050,642,1293,244,757,424,601,386,857,1243,443,203,94,465,601,2440,0.432,0.497,0.322,0.705
666,2020-21,Oregon,29,21,7,0.75,693,1570,484,959,209,611,320,419,249,649,898,379,138,78,385,439,1915,0.441,0.505,0.342,0.764
667,2019-20,Oregon,31,24,7,0.774,724,1780,488,1057,236,723,385,525,342,690,1032,385,127,110,418,480,2069,0.407,0.462,0.326,0.733
668,2023-24,Oral Roberts,31,12,19,0.387,831,1882,573,1160,258,722,414,566,344,844,1188,404,153,79,334,428,2334,0.442,0.494,0.357,0.731
669,2022-23,Oral Roberts,35,30,5,0.857,918,2207,617,1339,301,868,321,448,368,919,1287,418,182,95,445,526,2458,0.416,0.461,0.347,0.717
670,2021-22,Oral Roberts,31,19,12,0.613,867,1984,633,1279,234,705,338,481,279,836,1115,339,170,104,326,479,2306,0.437,0.495,0.332,0.703
671,2020-21,Oral Roberts,29,18,11,0.621,797,1839,599,1254,198,585,400,573,348,797,1145,352,163,86,393,490,2192,0.433,0.478,0.338,0.698
672,2019-20,Oral Roberts,31,17,14,0.548,811,1848,570,1129,241,719,402,558,294,799,1093,404,138,103,416,528,2265,0.439,0.505,0.335,0.72
673,2023-24,Omaha,33,15,18,0.455,839,1871,553,1065,286,806,440,593,271,844,1115,409,177,77,373,604,2404,0.448,0.519,0.355,0.742
674,2022-23,Omaha,32,9,23,0.281,851,1859,576,1099,275,760,461,616,311,809,1120,443,228,101,349,503,2438,0.458,0.524,0.362,0.748
675,2021-22,Omaha,30,5,25,0.167,869,1809,593,1110,276,699,491,669,296,820,1116,418,193,85,319,506,2505,0.48,0.534,0.395,0.734
676,2020-21,Omaha,25,5,20,0.2,698,1500,489,956,209,544,344,467,232,710,942,346,159,70,303,436,1949,0.465,0.512,0.384,0.737
677,2019-20,Omaha,32,16,16,0.5,883,1965,604,1182,279,783,416,565,310,845,1155,473,179,104,372,517,2461,0.449,0.511,0.356,0.736
678,2023-24,Ole Miss,32,20,12,0.625,843,1916,604,1208,239,708,440,619,419,767,1186,467,210,97,398,554,2365,0.44,0.5,0.338,0.711
679,2022-23,Ole Miss,33,12,21,0.364,819,1873,601,1228,218,645,423,568,334,793,1127,459,234,93,398,506,2279,0.437,0.489,0.338,0.745
680,2021-22,Ole Miss,32,13,19,0.406,816,1792,607,1144,209,648,356,502,280,814,1094,486,220,105,420,510,2197,0.455,0.531,0.323,0.709
681,2020-21,Ole Miss,28,16,12,0.571,623,1482,432,941,191,541,345,500,255,637,892,364,194,90,424,483,1782,0.42,0.459,0.353,0.69
682,2019-20,Ole Miss,32,15,17,0.469,745,1750,568,1143,177,607,526,711,306,810,1116,411,194,123,435,595,2193,0.426,0.497,0.292,0.74
683,2023-24,Old Dominion,32,7,25,0.219,825,1893,545,1099,280,794,534,744,362,933,1295,471,193,133,415,490,2464,0.436,0.496,0.353,0.718
684,2022-23,Old Dominion,31,19,12,0.613,714,1730,485,999,229,731,395,593,322,767,1089,398,182,122,355,556,2052,0.413,0.485,0.313,0.666
685,2021-22,Old Dominion,32,13,19,0.406,758,1810,479,992,279,818,350,516,313,769,1082,416,178,86,360,503,2145,0.419,0.483,0.341,0.678
686,2020-21,Old Dominion,23,15,8,0.652,547,1305,351,746,196,559,266,382,205,574,779,303,147,77,300,375,1556,0.419,0.471,0.351,0.696
687,2019-20,Old Dominion,32,13,19,0.406,704,1739,438,952,266,787,425,591,244,842,1086,384,164,120,402,514,2099,0.405,0.46,0.338,0.719
688,2023-24,Oklahoma State,32,12,20,0.375,865,1891,653,1268,212,623,385,522,312,775,1087,396,257,99,369,530,2327,0.457,0.515,0.34,0.738
689,2022-23,Oklahoma State,36,20,16,0.556,820,2076,565,1268,255,808,475,632,367,846,1213,428,275,94,464,623,2370,0.395,0.446,0.316,0.752
690,2021-22,Oklahoma State,30,15,15,0.5,677,1730,452,1036,225,694,391,539,351,728,1079,345,247,103,482,505,1970,0.391,0.436,0.324,0.725
691,2020-21,Oklahoma State,30,21,9,0.7,768,1869,545,1171,223,698,422,586,348,734,1082,371,241,135,440,552,2181,0.411,0.465,0.319,0.72
692,2019-20,Oklahoma State,32,18,14,0.563,722,1801,483,1001,239,800,432,597,334,781,1115,409,197,106,450,564,2115,0.401,0.483,0.299,0.724
693,2023-24,Oklahoma,32,20,12,0.625,782,1855,584,1193,198,662,439,578,290,719,1009,375,232,114,364,572,2201,0.422,0.49,0.299,0.76
694,2022-23,Oklahoma,32,15,17,0.469,797,1845,620,1278,177,567,390,555,305,745,1050,342,228,106,332,502,2161,0.432,0.485,0.312,0.703
695,2021-22,Oklahoma,35,19,16,0.543,846,1927,635,1263,211,664,373,508,300,772,1072,374,268,96,477,532,2276,0.439,0.503,0.318,0.734
696,2020-21,Oklahoma,27,16,11,0.593,687,1627,464,1002,223,625,289,386,266,711,977,327,152,82,349,444,1886,0.422,0.463,0.357,0.749
697,2019-20,Oklahoma,31,19,12,0.613,777,1946,515,1166,262,780,273,384,333,849,1182,368,192,78,361,536,2089,0.399,0.442,0.336,0.711
698,2023-24,Ohio State,36,22,14,0.611,913,2133,664,1416,249,717,453,638,376,859,1235,429,183,98,388,655,2528,0.428,0.469,0.347,0.71
699,2022-23,Ohio State,35,16,19,0.457,879,2046,638,1295,241,751,415,574,355,804,1159,432,164,99,369,545,2414,0.43,0.493,0.321,0.723
700,2021-22,Ohio State,32,20,12,0.625,772,1860,546,1191,226,669,396,542,329,694,1023,369,198,80,325,551,2166,0.415,0.458,0.338,0.731
701,2020-21,Ohio State,31,21,10,0.677,767,1821,529,1121,238,700,432,610,307,734,1041,424,149,82,312,588,2204,0.421,0.472,0.34,0.708
702,2019-20,Ohio State,31,21,10,0.677,688,1733,464,1049,224,684,351,508,284,694,978,338,154,95,379,578,1951,0.397,0.442,0.327,0.691
703,2023-24,Ohio,33,20,13,0.606,809,1904,571,1189,238,715,453,649,375,823,1198,363,165,117,452,560,2309,0.425,0.48,0.333,0.698
704,2022-23,Ohio,33,19,14,0.576,860,1932,606,1185,254,747,439,647,335,800,1135,404,193,106,410,535,2413,0.445,0.511,0.34,0.679
705,2021-22,Ohio,35,25,10,0.714,868,1958,637,1224,231,734,411,540,295,930,1225,397,199,114,498,641,2378,0.443,0.52,0.315,0.761
706,2020-21,Ohio,25,17,8,0.68,646,1468,449,885,197,583,326,429,228,612,840,345,141,65,344,441,1815,0.44,0.507,0.338,0.76
707,2019-20,Ohio,32,17,15,0.531,754,1802,515,1075,239,727,445,570,273,803,1076,354,199,76,405,572,2192,0.418,0.479,0.329,0.781
708,2023-24,Oakland,36,24,12,0.667,951,2175,650,1286,301,889,431,586,371,877,1248,595,215,108,403,593,2634,0.437,0.505,0.339,0.735
709,2022-23,Oakland,32,13,19,0.406,912,1949,629,1180,283,769,335,442,345,829,1174,563,183,94,438,536,2442,0.468,0.533,0.368,0.758
710,2021-22,Oakland,32,20,12,0.625,833,1934,586,1124,247,810,281,399,379,753,1132,520,193,98,471,539,2194,0.431,0.521,0.305,0.704
711,2020-21,Oakland,30,12,18,0.4,919,1937,610,1109,309,828,289,412,358,809,1167,630,189,110,410,542,2436,0.474,0.55,0.373,0.701
712,2019-20,Oakland,33,14,19,0.424,838,1984,555,1123,283,861,342,509,369,825,1194,482,218,94,404,649,2301,0.422,0.494,0.329,0.672
713,2023-24,Notre Dame,33,13,20,0.394,806,1910,578,1208,228,702,376,524,313,816,1129,406,212,120,328,484,2216,0.422,0.478,0.325,0.718
714,2022-23,Notre Dame,32,11,21,0.344,854,1862,623,1189,231,673,368,494,283,863,1146,433,154,103,286,463,2307,0.459,0.524,0.343,0.745
715,2021-22,Notre Dame,35,24,11,0.686,898,2083,662,1349,236,734,317,457,310,869,1179,407,209,106,352,526,2349,0.431,0.491,0.322,0.694
716,2020-21,Notre Dame,26,11,15,0.423,737,1665,518,1067,219,598,240,328,288,664,952,363,158,99,223,394,1933,0.443,0.485,0.366,0.732
717,2019-20,Notre Dame,32,20,12,0.625,832,2011,587,1283,245,728,286,397,347,874,1221,422,181,101,373,491,2197,0.414,0.458,0.337,0.72
718,2023-24,Northwestern State,32,9,23,0.281,840,1860,617,1168,223,692,526,755,390,822,1212,423,230,139,429,564,2429,0.452,0.528,0.322,0.697
719,2022-23,Northwestern State,33,22,11,0.667,826,1819,622,1205,204,614,522,695,364,816,1180,431,183,107,489,551,2378,0.454,0.516,0.332,0.751
720,2021-22,Northwestern State,32,9,23,0.281,930,2010,686,1299,244,711,469,634,369,847,1216,468,255,105,404,504,2573,0.463,0.528,0.343,0.74
721,2020-21,Northwestern State,29,11,18,0.379,843,1783,642,1160,201,623,425,620,335,813,1148,467,215,90,391,485,2312,0.473,0.553,0.323,0.685
722,2019-20,Northwestern State,30,15,15,0.5,773,1891,544,1221,229,670,495,696,388,746,1134,418,248,77,411,555,2270,0.409,0.446,0.342,0.711
723,2023-24,Northwestern,34,22,12,0.647,806,1788,576,1120,230,668,506,702,300,837,1137,477,167,133,422,567,2348,0.451,0.514,0.344,0.721
724,2022-23,Northwestern,34,22,12,0.647,745,1801,490,1046,255,755,389,570,316,877,1193,457,154,113,473,561,2134,0.414,0.468,0.338,0.682
725,2021-22,Northwestern,31,15,16,0.484,739,1726,476,1013,263,713,427,594,264,865,1129,453,157,111,420,527,2168,0.428,0.47,0.369,0.719
726,2020-21,Northwestern,24,9,15,0.375,586,1369,393,785,193,584,316,446,212,649,861,357,143,78,308,390,1681,0.428,0.501,0.33,0.709
727,2019-20,Northwestern,31,8,23,0.258,769,1832,505,1055,264,777,370,524,333,850,1183,481,170,105,331,469,2172,0.42,0.479,0.34,0.706
728,2023-24,Northern Kentucky,33,18,15,0.545,875,1968,621,1153,254,815,412,566,373,814,1187,485,213,115,480,591,2416,0.445,0.539,0.312,0.728
729,2022-23,Northern Kentucky,35,22,13,0.629,793,1808,538,1104,255,704,383,543,351,829,1180,484,199,84,549,554,2224,0.439,0.487,0.362,0.705
730,2021-22,Northern Kentucky,32,20,12,0.625,762,1786,537,1086,225,700,334,447,324,729,1053,428,205,86,458,461,2083,0.427,0.494,0.321,0.747
731,2020-21,Northern Kentucky,25,14,11,0.56,641,1421,453,891,188,530,311,462,275,568,843,345,154,54,317,413,1781,0.451,0.508,0.355,0.673
732,2019-20,Northern Kentucky,32,23,9,0.719,766,1850,581,1218,185,632,372,557,362,823,1185,399,176,64,463,595,2089,0.414,0.477,0.293,0.668
733,2023-24,Northern Iowa,33,19,14,0.576,826,1856,560,1086,266,770,428,557,246,846,1092,375,198,97,375,584,2346,0.445,0.516,0.345,0.768
734,2022-23,Northern Iowa,32,14,18,0.438,800,1783,504,946,296,837,342,471,234,820,1054,417,215,77,409,514,2238,0.449,0.533,0.354,0.726
735,2021-22,Northern Iowa,32,20,12,0.625,828,1840,513,944,315,896,302,415,230,811,1041,423,202,73,395,523,2273,0.45,0.543,0.352,0.728
736,2020-21,Northern Iowa,25,10,15,0.4,651,1437,451,828,200,609,277,376,178,658,836,342,183,71,303,390,1779,0.453,0.545,0.328,0.737
737,2019-20,Northern Iowa,31,25,6,0.806,743,1778,520,1109,223,669,297,434,249,694,943,327,209,74,321,471,2006,0.418,0.469,0.333,0.684
738,2023-24,Northern Illinois,31,11,20,0.355,853,1898,606,1217,247,681,446,655,359,782,1141,457,210,77,338,581,2399,0.449,0.498,0.363,0.681
739,2022-23,Northern Illinois,32,13,19,0.406,852,1895,623,1197,229,698,468,676,376,827,1203,413,215,97,433,549,2401,0.45,0.52,0.328,0.692
740,2021-22,Northern Illinois,30,9,21,0.3,734,1643,540,1043,194,600,484,668,298,792,1090,398,193,139,407,517,2146,0.447,0.518,0.323,0.725
741,2020-21,Northern Illinois,19,3,16,0.158,511,1096,334,642,177,454,272,370,201,503,704,300,115,58,217,300,1471,0.466,0.52,0.39,0.735
742,2019-20,Northern Illinois,31,18,13,0.581,691,1719,462,969,229,750,387,535,268,796,1064,357,152,99,358,511,1998,0.402,0.477,0.305,0.723
743,2023-24,Northern Colorado,33,19,14,0.576,912,2028,627,1217,285,811,433,579,295,838,1133,426,223,99,374,537,2542,0.45,0.515,0.351,0.748
744,2022-23,Northern Colorado,32,12,20,0.375,911,1922,700,1283,211,639,447,615,296,822,1118,440,170,116,313,552,2480,0.474,0.546,0.33,0.727
745,2021-22,Northern Colorado,38,22,16,0.579,1070,2330,784,1558,286,772,498,681,310,968,1278,415,234,85,374,666,2924,0.459,0.503,0.37,0.731
746,2020-21,Northern Colorado,22,11,11,0.5,562,1261,475,968,87,293,308,409,155,539,694,199,137,55,233,367,1519,0.446,0.491,0.297,0.753
747,2019-20,Northern Colorado,31,22,9,0.71,767,1736,654,1332,113,404,298,429,233,765,998,252,143,89,348,470,1945,0.442,0.491,0.28,0.695
748,2023-24,Northern Arizona,33,14,19,0.424,905,1908,697,1259,208,649,511,714,343,864,1207,425,244,95,384,560,2529,0.474,0.554,0.32,0.716
749,2022-23,Northern Arizona,35,12,23,0.343,905,1917,644,1178,261,739,544,734,280,910,1190,474,172,112,424,608,2615,0.472,0.547,0.353,0.741
750,2021-22,Northern Arizona,32,9,23,0.281,829,1823,592,1166,237,657,452,622,245,833,1078,376,189,97,311,525,2347,0.455,0.508,0.361,0.727
751,2020-21,Northern Arizona,22,6,16,0.273,583,1164,393,651,190,513,284,386,174,571,745,331,118,66,266,384,1640,0.501,0.604,0.37,0.736
752,2019-20,Northern Arizona,30,16,14,0.533,764,1674,545,1058,219,616,334,457,244,750,994,395,159,77,389,501,2081,0.456,0.515,0.356,0.731
753,2023-24,Northeastern,32,12,20,0.375,834,1792,573,1096,261,696,386,507,282,699,981,425,208,96,357,488,2315,0.465,0.523,0.375,0.761
754,2022-23,Northeastern,30,10,20,0.333,787,1750,607,1234,180,516,396,554,276,712,988,358,227,95,293,462,2150,0.45,0.492,0.349,0.715
755,2021-22,Northeastern,31,9,22,0.29,792,1744,571,1100,221,644,337,446,230,699,929,367,227,69,320,498,2142,0.454,0.519,0.343,0.756
756,2020-21,Northeastern,19,10,9,0.526,479,1108,366,758,113,350,227,325,177,498,675,220,129,41,226,294,1298,0.432,0.483,0.323,0.698
757,2019-20,Northeastern,33,17,16,0.515,793,1745,575,1081,218,664,387,534,248,745,993,342,173,78,431,505,2191,0.454,0.532,0.328,0.725
758,2023-24,North Texas,34,19,15,0.559,740,1785,528,1144,212,641,477,667,356,755,1111,339,227,135,419,516,2169,0.415,0.462,0.331,0.715
759,2022-23,North Texas,38,31,7,0.816,712,1822,518,1179,194,643,503,733,346,776,1122,299,206,81,465,616,2121,0.391,0.439,0.302,0.686
760,2021-22,North Texas,32,25,7,0.781,654,1581,520,1110,134,471,341,503,248,697,945,262,186,80,388,547,1783,0.414,0.468,0.285,0.678
761,2020-21,North Texas,28,18,10,0.643,619,1501,441,968,178,533,329,455,253,609,862,267,175,81,387,422,1745,0.412,0.456,0.334,0.723
762,2019-20,North Texas,31,20,11,0.645,671,1587,470,1009,201,578,419,606,279,629,908,316,220,94,425,518,1962,0.423,0.466,0.348,0.691
763,2023-24,North Florida,32,16,16,0.5,889,1928,689,1347,200,581,449,614,313,831,1144,394,221,91,336,485,2427,0.461,0.512,0.344,0.731
764,2022-23,North Florida,31,14,17,0.452,929,2004,724,1422,205,582,342,468,367,790,1157,486,218,91,316,497,2405,0.464,0.509,0.352,0.731
765,2021-22,North Florida,31,11,20,0.355,830,1964,642,1375,188,589,358,523,430,794,1224,437,256,89,373,502,2206,0.423,0.467,0.319,0.685
766,2020-21,North Florida,23,8,15,0.348,629,1405,490,988,139,417,328,445,288,561,849,352,183,68,251,357,1725,0.448,0.496,0.333,0.737
767,2019-20,North Florida,33,21,12,0.636,934,2024,777,1530,157,494,391,559,371,824,1195,489,188,94,377,508,2416,0.461,0.508,0.318,0.699
768,2023-24,North Dakota State,32,15,17,0.469,879,1909,647,1262,232,647,376,517,256,770,1026,369,171,115,303,510,2366,0.46,0.513,0.359,0.727
769,2022-23,North Dakota State,33,16,17,0.485,884,2006,641,1287,243,719,403,535,270,825,1095,378,214,86,295,552,2414,0.441,0.498,0.338,0.753
770,2021-22,North Dakota State,33,23,10,0.697,845,2014,635,1357,210,657,367,493,268,810,1078,321,179,73,302,581,2267,0.42,0.468,0.32,0.744
771,2020-21,North Dakota State,27,15,12,0.556,674,1541,483,975,191,566,288,405,182,637,819,324,136,73,249,448,1827,0.437,0.495,0.337,0.711
772,2019-20,North Dakota State,33,25,8,0.758,822,1889,630,1298,192,591,347,483,209,846,1055,314,152,95,338,553,2183,0.435,0.485,0.325,0.718
773,2023-24,North Dakota,32,18,14,0.563,849,1871,635,1235,214,636,388,524,277,800,1077,339,187,61,343,550,2300,0.454,0.514,0.336,0.74
774,2022-23,North Dakota,33,13,20,0.394,916,1948,699,1330,217,618,389,522,291,869,1160,364,200,94,360,568,2438,0.47,0.526,0.351,0.745
775,2021-22,North Dakota,31,6,25,0.194,908,1859,661,1192,247,667,381,549,270,856,1126,421,197,95,308,579,2444,0.488,0.555,0.37,0.694
776,2020-21,North Dakota,26,9,17,0.346,715,1519,529,1035,186,484,353,462,227,700,927,334,167,88,308,477,1969,0.471,0.511,0.384,0.764
777,2019-20,North Dakota,33,15,18,0.455,908,1999,672,1355,236,644,415,565,281,807,1088,402,218,89,361,612,2467,0.454,0.496,0.366,0.735
778,2023-24,North Carolina Central,31,18,13,0.581,747,1773,566,1129,181,644,464,638,360,736,1096,381,179,106,432,564,2139,0.421,0.501,0.281,0.727
779,2022-23,North Carolina Central,30,18,12,0.6,704,1657,519,1048,185,609,384,564,298,668,966,384,203,117,503,548,1977,0.425,0.495,0.304,0.681
780,2021-22,North Carolina Central,31,16,15,0.516,703,1662,480,963,223,699,491,693,304,718,1022,386,216,138,522,592,2120,0.423,0.498,0.319,0.709
781,2020-21,North Carolina Central,14,5,9,0.357,346,771,252,496,94,275,217,299,150,372,522,201,91,46,215,256,1003,0.449,0.508,0.342,0.726
782,2019-20,North Carolina Central,31,18,13,0.581,724,1751,519,1071,205,680,392,563,354,736,1090,370,188,93,533,522,2045,0.413,0.485,0.301,0.696
783,2023-24,North Carolina A&T,32,7,25,0.219,926,1931,673,1212,253,719,389,570,371,935,1306,491,169,113,347,534,2494,0.48,0.555,0.352,0.682
784,2022-23,North Carolina A&T,32,13,19,0.406,853,1965,610,1231,243,734,413,568,358,900,1258,417,162,91,393,489,2362,0.434,0.496,0.331,0.727
785,2021-22,North Carolina A&T,32,12,20,0.375,769,1792,517,1055,252,737,460,654,336,833,1169,445,218,76,446,498,2250,0.429,0.49,0.342,0.703
786,2020-21,North Carolina A&T,21,11,10,0.524,550,1264,380,776,170,488,253,377,256,593,849,330,123,84,392,402,1523,0.435,0.49,0.348,0.671
787,2019-20,North Carolina A&T,32,17,15,0.531,795,1909,583,1172,212,737,503,792,377,898,1275,418,213,105,526,647,2305,0.416,0.497,0.288,0.635
788,2023-24,North Carolina,37,29,8,0.784,935,2281,673,1464,262,817,476,644,331,919,1250,374,203,141,392,690,2608,0.41,0.46,0.321,0.739
789,2022-23,North Carolina,33,20,13,0.606,876,2017,663,1371,213,646,375,530,284,843,1127,368,188,113,345,617,2340,0.434,0.484,0.33,0.708
790,2021-22,North Carolina,39,29,10,0.744,1048,2464,747,1571,301,893,383,528,319,957,1276,498,259,139,378,645,2780,0.425,0.475,0.337,0.725
791,2020-21,North Carolina,29,18,11,0.621,735,1734,502,1069,233,665,325,466,280,663,943,376,247,133,396,526,2028,0.424,0.47,0.35,0.697
792,2019-20,North Carolina,33,14,19,0.424,843,1999,566,1175,277,824,440,583,296,835,1131,455,229,138,378,616,2403,0.422,0.482,0.336,0.755
793,2023-24,North Alabama,32,15,17,0.469,833,1870,606,1221,227,649,542,750,310,825,1135,396,166,112,325,560,2435,0.445,0.496,0.35,0.723
794,2022-23,North Alabama,33,18,15,0.545,878,1988,614,1266,264,722,432,606,326,858,1184,442,191,125,372,513,2452,0.442,0.485,0.366,0.713
795,2021-22,North Alabama,30,9,21,0.3,707,1673,524,1108,183,565,459,661,300,866,1166,318,182,115,446,426,2056,0.423,0.473,0.324,0.694
796,2020-21,North Alabama,24,13,11,0.542,577,1378,378,795,199,583,313,454,206,634,840,253,140,70,341,417,1666,0.419,0.475,0.341,0.689
797,2019-20,North Alabama,30,13,17,0.433,725,1657,537,1098,188,559,454,650,277,756,1033,317,168,112,420,566,2092,0.438,0.489,0.336,0.698
798,2023-24,Norfolk State,35,24,11,0.686,762,1866,477,1024,285,842,555,768,363,795,1158,466,205,104,538,645,2364,0.408,0.466,0.338,0.723
799,2022-23,Norfolk State,33,22,11,0.667,747,1832,446,965,301,867,469,685,345,687,1032,463,218,87,458,637,2264,0.408,0.462,0.347,0.685
800,2021-22,Norfolk State,31,24,7,0.774,687,1807,449,991,238,816,385,598,322,719,1041,379,179,101,424,564,1997,0.38,0.453,0.292,0.644
801,2020-21,Norfolk State,25,17,8,0.68,573,1419,370,777,203,642,393,561,263,659,922,317,140,94,384,476,1742,0.404,0.476,0.316,0.701
802,2019-20,Norfolk State,31,16,15,0.516,670,1676,464,992,206,684,466,674,306,789,1095,402,174,97,497,550,2012,0.4,0.468,0.301,0.691
803,2023-24,NJIT,28,7,21,0.25,735,1598,537,1030,198,568,433,626,306,753,1059,397,170,98,331,444,2101,0.46,0.521,0.349,0.692
804,2022-23,NJIT,30,7,23,0.233,808,1789,576,1098,232,691,334,498,306,812,1118,397,156,103,303,487,2182,0.452,0.525,0.336,0.671
805,2021-22,NJIT,29,11,18,0.379,741,1712,508,1016,233,696,315,453,281,802,1083,399,197,95,335,491,2030,0.433,0.5,0.335,0.695
806,2020-21,NJIT,19,7,12,0.368,494,1065,367,682,127,383,218,313,175,532,707,241,88,65,274,363,1333,0.464,0.538,0.332,0.696
807,2019-20,NJIT,30,9,21,0.3,722,1642,525,1062,197,580,389,537,260,818,1078,374,157,108,370,491,2030,0.44,0.494,0.34,0.724
808,2023-24,Nicholls State,34,20,14,0.588,879,2025,650,1298,229,727,527,779,403,849,1252,435,259,125,389,592,2514,0.434,0.501,0.315,0.677
809,2022-23,Nicholls State,31,16,15,0.516,743,1670,525,1026,218,644,549,761,321,793,1114,439,191,95,549,531,2253,0.445,0.512,0.339,0.721
810,2021-22,Nicholls State,33,21,12,0.636,816,1963,571,1231,245,732,475,666,368,848,1216,441,186,83,504,487,2352,0.416,0.464,0.335,0.713
811,2020-21,Nicholls State,25,18,7,0.72,644,1503,458,965,186,538,357,512,261,685,946,317,144,67,395,428,1831,0.428,0.475,0.346,0.697
812,2019-20,Nicholls State,31,21,10,0.677,742,1715,565,1139,177,576,484,670,336,789,1125,405,199,83,575,510,2144,0.433,0.496,0.307,0.722
813,2023-24,Niagara,32,16,16,0.5,862,1834,683,1326,179,508,404,567,264,744,1008,357,212,105,363,577,2307,0.47,0.515,0.352,0.713
814,2022-23,Niagara,31,16,15,0.516,731,1664,549,1155,182,509,400,553,270,679,949,321,166,110,336,501,2044,0.439,0.475,0.358,0.723
815,2021-22,Niagara,30,14,16,0.467,704,1694,497,1070,207,624,350,469,267,757,1024,369,153,85,345,482,1965,0.416,0.464,0.332,0.746
816,2020-21,Niagara,20,9,11,0.45,453,1067,303,625,150,442,248,347,186,536,722,276,93,65,264,369,1304,0.425,0.485,0.339,0.715
817,2019-20,Niagara,32,12,20,0.375,842,1851,572,1092,270,759,362,511,386,882,1268,523,152,110,444,491,2316,0.455,0.524,0.356,0.708
818,2023-24,New Orleans,33,10,23,0.303,937,1997,723,1366,214,631,534,738,403,911,1314,502,210,132,483,665,2622,0.469,0.529,0.339,0.724
819,2022-23,New Orleans,32,12,20,0.375,881,1858,636,1181,245,677,529,712,350,736,1086,435,280,81,486,612,2536,0.474,0.539,0.362,0.743
820,2021-22,New Orleans,32,18,14,0.563,851,1990,609,1202,242,788,441,636,376,827,1203,479,226,120,493,629,2385,0.428,0.507,0.307,0.693
821,2020-21,New Orleans,25,10,15,0.4,684,1511,525,1012,159,499,383,559,293,594,887,336,209,94,393,446,1910,0.453,0.519,0.319,0.685
822,2019-20,New Orleans,30,9,21,0.3,823,1697,622,1118,201,579,476,650,309,711,1020,460,196,125,481,583,2323,0.485,0.556,0.347,0.732
823,2023-24,New Mexico State,32,13,19,0.406,762,1812,501,1046,261,766,533,759,312,816,1128,428,228,85,373,525,2318,0.421,0.479,0.341,0.702
824,2022-23,New Mexico State,24,9,15,0.375,584,1369,371,751,213,618,339,477,203,603,806,297,131,65,333,449,1720,0.427,0.494,0.345,0.711
825,2021-22,New Mexico State,34,27,7,0.794,768,1976,514,1133,254,843,407,545,310,748,1058,382,234,70,406,638,2197,0.389,0.454,0.301,0.747
826,2020-21,New Mexico State,20,12,8,0.6,452,1051,328,668,124,383,255,358,154,455,609,231,94,42,257,360,1283,0.43,0.491,0.324,0.712
827,2019-20,New Mexico State,31,25,6,0.806,658,1554,469,969,189,585,347,475,201,643,844,311,188,61,428,568,1852,0.423,0.484,0.323,0.731
828,2023-24,New Mexico,36,26,10,0.722,896,2122,662,1351,234,771,519,710,354,922,1276,486,211,155,504,653,2545,0.422,0.49,0.304,0.731
829,2022-23,New Mexico,34,22,12,0.647,916,2100,645,1290,271,810,422,607,344,849,1193,482,200,101,433,679,2525,0.436,0.5,0.335,0.695
830,2021-22,New Mexico,32,13,19,0.406,863,1893,652,1244,211,649,474,647,317,889,1206,449,192,102,422,570,2411,0.456,0.524,0.325,0.733
831,2020-21,New Mexico,22,6,16,0.273,557,1255,377,727,180,528,284,414,213,558,771,319,177,67,299,399,1578,0.444,0.519,0.341,0.686
832,2019-20,New Mexico,33,19,14,0.576,918,2041,617,1172,301,869,346,501,364,820,1184,537,232,85,486,635,2483,0.45,0.526,0.346,0.691
833,2023-24,New Hampshire,31,16,15,0.516,843,1930,620,1182,223,748,388,531,289,916,1205,426,234,142,380,507,2297,0.437,0.525,0.298,0.731
834,2022-23,New Hampshire,30,15,15,0.5,741,1701,565,1135,176,566,353,505,274,831,1105,299,166,83,329,480,2011,0.436,0.498,0.311,0.699
835,2021-22,New Hampshire,28,15,13,0.536,662,1535,456,930,206,605,289,385,196,690,886,272,138,73,265,429,1819,0.431,0.49,0.34,0.751
836,2020-21,New Hampshire,19,10,9,0.526,434,1011,312,656,122,355,276,386,139,526,665,182,101,68,237,358,1266,0.429,0.476,0.344,0.715
837,2019-20,New Hampshire,30,15,15,0.5,677,1694,477,1048,200,646,436,634,231,822,1053,275,186,87,360,518,1990,0.4,0.455,0.31,0.688
838,2023-24,Nevada,34,26,8,0.765,789,1886,538,1103,251,783,447,639,317,793,1110,441,169,80,405,716,2276,0.418,0.488,0.321,0.7
839,2022-23,Nevada,33,22,11,0.667,781,1836,526,1057,255,779,421,577,280,827,1107,421,168,94,413,637,2238,0.425,0.498,0.327,0.73
840,2021-22,Nevada,31,13,18,0.419,807,1829,520,1025,287,804,381,528,276,791,1067,451,186,83,403,563,2284,0.441,0.507,0.357,0.722
841,2020-21,Nevada,26,16,10,0.615,592,1448,380,810,212,638,416,582,231,666,897,356,169,66,324,505,1812,0.409,0.469,0.332,0.715
842,2019-20,Nevada,31,19,12,0.613,753,1866,507,1040,246,826,489,682,297,807,1104,384,148,80,338,513,2243,0.404,0.488,0.298,0.717
843,2023-24,Nebraska,34,23,11,0.676,854,2136,566,1251,288,885,415,592,414,854,1268,448,209,125,387,551,2411,0.4,0.452,0.325,0.701
844,2022-23,Nebraska,32,16,16,0.5,826,1943,537,1095,289,848,295,425,332,805,1137,492,215,137,386,538,2236,0.425,0.49,0.341,0.694
845,2021-22,Nebraska,32,10,22,0.313,900,2022,617,1206,283,816,430,595,375,909,1284,457,227,120,429,581,2513,0.445,0.512,0.347,0.723
846,2020-21,Nebraska,27,7,20,0.259,711,1686,471,915,240,771,342,476,291,782,1073,388,184,98,356,466,2004,0.422,0.515,0.311,0.718
847,2019-20,Nebraska,32,7,25,0.219,957,2126,681,1298,276,828,309,463,412,1030,1442,498,181,167,443,534,2499,0.45,0.525,0.333,0.667
848,2023-24,NC State,41,26,15,0.634,1043,2408,746,1521,297,887,559,760,424,1060,1484,527,210,130,501,662,2942,0.433,0.49,0.335,0.736
849,2022-23,NC State,34,23,11,0.676,859,1931,654,1283,205,648,485,657,304,881,1185,393,172,94,449,534,2408,0.445,0.51,0.316,0.738
850,2021-22,NC State,32,11,21,0.344,887,1879,653,1228,234,651,411,553,333,871,1204,468,179,134,407,537,2419,0.472,0.532,0.359,0.743
851,2020-21,NC State,25,14,11,0.56,640,1415,470,918,170,497,292,403,262,578,840,327,158,93,371,429,1742,0.452,0.512,0.342,0.725
852,2019-20,NC State,32,20,12,0.625,792,1857,599,1247,193,610,454,658,363,824,1187,344,213,109,455,536,2231,0.426,0.48,0.316,0.69
853,2023-24,Navy,31,13,18,0.419,715,1660,494,977,221,683,416,582,309,807,1116,397,147,148,420,568,2067,0.431,0.506,0.324,0.715
854,2022-23,Navy,31,18,13,0.581,733,1684,511,1033,222,651,325,497,290,720,1010,403,179,96,402,474,2013,0.435,0.495,0.341,0.654
855,2021-22,Navy,32,21,11,0.656,678,1668,469,1031,209,637,359,524,262,744,1006,383,223,108,432,536,1924,0.406,0.455,0.328,0.685
856,2020-21,Navy,18,15,3,0.833,436,950,312,581,124,369,210,309,142,427,569,234,110,64,275,355,1206,0.459,0.537,0.336,0.68
857,2019-20,Navy,30,14,16,0.467,692,1591,471,939,221,652,319,470,244,705,949,390,177,125,346,505,1924,0.435,0.502,0.339,0.679
858,2023-24,Murray State,32,12,20,0.375,811,1750,538,1007,273,743,342,474,253,810,1063,433,155,105,379,490,2237,0.463,0.534,0.367,0.722
859,2022-23,Murray State,32,17,15,0.531,854,1909,589,1115,265,794,332,462,303,790,1093,451,185,92,347,537,2305,0.447,0.528,0.334,0.719
860,2021-22,Murray State,34,31,3,0.912,788,1912,556,1138,232,774,342,504,302,761,1063,351,183,134,471,572,2150,0.412,0.489,0.3,0.679
861,2020-21,Murray State,26,13,13,0.5,620,1478,427,874,193,604,306,445,227,605,832,292,136,102,348,369,1739,0.419,0.489,0.32,0.688
862,2019-20,Murray State,32,23,9,0.719,734,1833,527,1167,207,666,395,574,283,731,1014,335,193,115,414,602,2070,0.4,0.452,0.311,0.688
863,2023-24,Mount St. Mary's,32,13,19,0.406,819,1890,592,1233,227,657,433,572,315,722,1037,406,285,92,403,478,2298,0.433,0.48,0.346,0.757
864,2022-23,Mount St. Mary's,33,13,20,0.394,797,1880,571,1202,226,678,392,548,337,799,1136,390,253,99,392,507,2212,0.424,0.475,0.333,0.715
865,2021-22,Mount St. Mary's,30,14,16,0.467,723,1687,537,1125,186,562,326,438,288,701,989,332,210,81,370,480,1958,0.429,0.477,0.331,0.744
866,2020-21,Mount St. Mary's,23,12,11,0.522,526,1300,397,878,129,422,250,325,198,542,740,217,151,65,237,402,1431,0.405,0.452,0.306,0.769
867,2019-20,Mount St. Mary's,32,11,21,0.344,767,1776,535,1123,232,653,366,520,299,820,1119,396,176,111,366,578,2132,0.432,0.476,0.355,0.704
868,2023-24,Morgan State,31,11,20,0.355,846,1902,636,1290,210,612,500,730,413,746,1159,405,253,114,401,489,2402,0.445,0.493,0.343,0.685
869,2022-23,Morgan State,31,15,16,0.484,789,1793,603,1192,186,601,478,709,402,779,1181,439,259,120,586,519,2242,0.44,0.506,0.309,0.674
870,2021-22,Morgan State,28,13,15,0.464,682,1563,477,969,205,594,456,650,279,735,1014,340,212,110,537,498,2025,0.436,0.492,0.345,0.702
871,2020-21,Morgan State,22,14,8,0.636,533,1263,374,743,159,520,381,532,238,554,792,267,161,76,388,435,1606,0.422,0.503,0.306,0.716
872,2019-20,Morgan State,31,15,16,0.484,698,1716,493,1050,205,666,596,849,332,750,1082,350,212,106,444,604,2197,0.407,0.47,0.308,0.702
873,2023-24,Morehead State,35,26,9,0.743,789,2006,588,1341,201,665,441,587,327,746,1073,331,207,90,367,547,2220,0.393,0.438,0.302,0.751
874,2022-23,Morehead State,34,22,12,0.647,846,1932,652,1314,194,618,380,527,274,824,1098,365,195,110,381,582,2266,0.438,0.496,0.314,0.721
875,2021-22,Morehead State,34,23,11,0.676,813,1992,598,1334,215,658,317,461,346,775,1121,411,256,108,410,542,2158,0.408,0.448,0.327,0.688
876,2020-21,Morehead State,31,23,8,0.742,736,1806,505,1065,231,741,283,418,272,682,954,366,242,98,374,555,1986,0.408,0.474,0.312,0.677
877,2019-20,Morehead State,32,13,19,0.406,818,1914,587,1198,231,716,373,530,329,837,1166,387,191,156,402,534,2240,0.427,0.49,0.323,0.704
878,2023-24,Montana State,35,17,18,0.486,933,2000,705,1319,228,681,512,717,329,904,1233,431,207,87,474,600,2606,0.467,0.534,0.335,0.714
879,2022-23,Montana State,35,25,10,0.714,815,1885,593,1231,222,654,490,654,272,802,1074,322,196,70,479,716,2342,0.432,0.482,0.339,0.749
880,2021-22,Montana State,35,27,8,0.771,841,1965,613,1272,228,693,515,685,273,812,1085,336,226,98,450,696,2425,0.428,0.482,0.329,0.752
881,2020-21,Montana State,23,13,10,0.565,554,1292,382,793,172,499,375,484,193,563,756,246,135,66,311,471,1655,0.429,0.482,0.345,0.775
882,2019-20,Montana State,31,16,15,0.516,738,1787,507,1056,231,731,369,529,280,756,1036,376,201,106,350,570,2076,0.413,0.48,0.316,0.698
883,2023-24,Montana,36,24,12,0.667,926,2085,701,1412,225,673,509,706,331,842,1173,400,209,107,349,575,2586,0.444,0.496,0.334,0.721
884,2022-23,Montana,31,17,14,0.548,733,1626,548,1051,185,575,463,598,236,704,940,344,158,71,320,504,2114,0.451,0.521,0.322,0.774
885,2021-22,Montana,32,18,14,0.563,741,1683,560,1175,181,508,478,658,260,824,1084,323,132,89,421,575,2141,0.44,0.477,0.356,0.726
886,2020-21,Montana,28,15,13,0.536,667,1555,505,1035,162,520,380,567,252,667,919,324,165,77,351,507,1876,0.429,0.488,0.312,0.67
887,2019-20,Montana,31,18,13,0.581,713,1641,538,1124,175,517,521,727,250,799,1049,322,184,86,444,517,2122,0.434,0.479,0.338,0.717
888,2023-24,Monmouth,33,18,15,0.545,819,1919,537,1090,282,829,476,639,381,838,1219,460,185,126,400,520,2396,0.427,0.493,0.34,0.745
889,2022-23,Monmouth,33,7,26,0.212,828,1804,521,975,307,829,503,700,355,841,1196,463,228,130,474,593,2466,0.459,0.534,0.37,0.719
890,2021-22,Monmouth,34,21,13,0.618,786,1929,532,1142,254,787,463,649,342,853,1195,395,185,108,408,637,2289,0.407,0.466,0.323,0.713
891,2020-21,Monmouth,20,12,8,0.6,504,1200,345,716,159,484,319,461,220,572,792,280,131,85,317,418,1486,0.42,0.482,0.329,0.692
892,2019-20,Monmouth,31,18,13,0.581,724,1702,487,1013,237,689,503,710,307,880,1187,371,187,104,504,606,2188,0.425,0.481,0.344,0.708
893,2023-24,Missouri State,33,17,16,0.515,859,2067,594,1265,265,802,369,515,313,818,1131,428,215,107,301,548,2352,0.416,0.47,0.33,0.717
894,2022-23,Missouri State,32,17,15,0.531,722,1701,508,1041,214,660,363,504,276,721,997,353,202,102,380,449,2021,0.424,0.488,0.324,0.72
895,2021-22,Missouri State,34,23,11,0.676,837,1991,585,1231,252,760,416,551,279,820,1099,366,178,99,364,577,2342,0.42,0.475,0.332,0.755
896,2020-21,Missouri State,24,17,7,0.708,581,1418,417,915,164,503,268,390,198,570,768,250,135,60,246,400,1594,0.41,0.456,0.326,0.687
897,2019-20,Missouri State,33,16,17,0.485,785,1822,547,1117,238,705,430,604,254,767,1021,368,204,98,413,550,2238,0.431,0.49,0.338,0.712
898,2023-24,Missouri,32,8,24,0.25,809,1818,560,1094,249,724,571,771,388,800,1188,427,206,108,409,547,2438,0.445,0.512,0.344,0.741
899,2022-23,Missouri,35,25,10,0.714,891,1998,582,1114,309,884,513,683,443,867,1310,510,216,81,592,570,2604,0.446,0.522,0.35,0.751
900,2021-22,Missouri,33,12,21,0.364,819,1848,588,1193,231,655,456,655,335,768,1103,395,241,119,405,531,2325,0.443,0.493,0.353,0.696
901,2020-21,Missouri,26,16,10,0.615,654,1518,489,1021,165,497,397,556,271,645,916,296,161,105,332,494,1870,0.431,0.479,0.332,0.714
902,2019-20,Missouri,31,15,16,0.484,648,1587,475,986,173,601,551,759,289,737,1026,318,184,107,437,584,2020,0.408,0.482,0.288,0.726
903,2023-24,Mississippi Valley State,31,1,30,0.032,835,1711,604,1087,231,624,508,711,340,771,1111,452,273,98,354,519,2409,0.488,0.556,0.37,0.714
904,2022-23,Mississippi Valley State,32,5,27,0.156,826,1788,573,1082,253,706,487,711,341,788,1129,442,288,111,430,557,2392,0.462,0.53,0.358,0.685
905,2021-22,Mississippi Valley State,28,2,26,0.071,841,1671,633,1150,208,521,433,608,316,887,1203,437,191,102,429,472,2323,0.503,0.55,0.399,0.712
906,2020-21,Mississippi Valley State,24,2,22,0.083,771,1592,564,1014,207,578,348,518,322,765,1087,440,222,67,263,369,2097,0.484,0.556,0.358,0.672
907,2019-20,Mississippi Valley State,30,3,27,0.1,975,2028,736,1327,239,701,501,732,412,1022,1434,579,213,92,419,449,2690,0.481,0.555,0.341,0.684
908,2023-24,Mississippi State,35,21,14,0.6,844,2016,597,1186,247,830,482,641,346,794,1140,410,256,132,443,631,2417,0.419,0.503,0.298,0.752
909,2022-23,Mississippi State,34,21,13,0.618,728,1849,476,1040,252,809,365,510,340,798,1138,424,214,102,486,582,2073,0.394,0.458,0.311,0.716
910,2021-22,Mississippi State,34,18,16,0.529,808,1880,558,1096,250,784,386,532,294,743,1037,468,241,110,445,571,2252,0.43,0.509,0.319,0.726
911,2020-21,Mississippi State,33,18,15,0.545,791,1958,530,1155,261,803,363,486,337,718,1055,468,237,129,389,542,2206,0.404,0.459,0.325,0.747
912,2019-20,Mississippi State,31,20,11,0.645,751,1770,551,1129,200,641,410,559,311,633,944,379,220,92,356,575,2112,0.424,0.488,0.312,0.733
913,2023-24,Minnesota,34,19,15,0.559,898,1999,679,1390,219,609,429,592,342,774,1116,514,243,107,371,564,2444,0.449,0.488,0.36,0.725
914,2022-23,Minnesota,31,9,22,0.29,834,1856,626,1276,208,580,326,461,336,786,1122,433,207,110,302,524,2202,0.449,0.491,0.359,0.707
915,2021-22,Minnesota,30,13,17,0.433,793,1747,589,1141,204,606,286,407,279,846,1125,403,145,111,313,444,2076,0.454,0.516,0.337,0.703
916,2020-21,Minnesota,29,14,15,0.483,760,1722,568,1176,192,546,411,591,332,826,1158,432,155,78,394,570,2123,0.441,0.483,0.352,0.695
917,2019-20,Minnesota,31,15,16,0.484,756,1851,579,1274,177,577,366,518,331,790,1121,398,162,110,333,510,2055,0.408,0.454,0.307,0.707
918,2023-24,Milwaukee,35,20,15,0.571,962,2194,674,1358,288,836,541,724,413,845,1258,540,244,149,404,638,2753,0.438,0.496,0.344,0.747
919,2022-23,Milwaukee,34,22,12,0.647,893,2187,613,1275,280,912,456,629,438,799,1237,446,269,117,465,605,2522,0.408,0.481,0.307,0.725
920,2021-22,Milwaukee,32,10,22,0.313,782,1948,513,1144,269,804,431,564,365,817,1182,416,213,100,326,474,2264,0.401,0.448,0.335,0.764
921,2020-21,Milwaukee,22,10,12,0.455,582,1288,390,781,192,507,322,451,208,622,830,323,114,62,297,426,1678,0.452,0.499,0.379,0.714
922,2019-20,Milwaukee,31,12,19,0.387,756,1726,544,1114,212,612,528,735,313,844,1157,384,177,98,466,573,2252,0.438,0.488,0.346,0.718
923,2023-24,Middle Tennessee,33,14,19,0.424,854,1945,660,1356,194,589,417,574,354,840,1194,367,216,112,367,566,2319,0.439,0.487,0.329,0.726
924,2022-23,Middle Tennessee,33,19,14,0.576,789,1762,576,1162,213,600,445,588,303,744,1047,360,225,98,492,509,2236,0.448,0.496,0.355,0.757
925,2021-22,Middle Tennessee,37,26,11,0.703,851,2059,615,1295,236,764,548,734,376,878,1254,377,235,118,544,644,2486,0.413,0.475,0.309,0.747
926,2020-21,Middle Tennessee,23,5,18,0.217,610,1293,470,856,140,437,267,378,186,641,827,300,174,76,320,329,1627,0.472,0.549,0.32,0.706
927,2019-20,Middle Tennessee,31,8,23,0.258,817,1744,593,1151,224,593,474,672,281,848,1129,426,205,88,444,514,2332,0.468,0.515,0.378,0.705
928,2023-24,Michigan State,35,20,15,0.571,800,1938,537,1132,263,806,449,628,344,832,1176,438,186,112,432,588,2312,0.413,0.474,0.326,0.715
929,2022-23,Michigan State,34,21,13,0.618,834,1968,589,1211,245,757,396,550,305,805,1110,447,193,117,333,556,2309,0.424,0.486,0.324,0.72
930,2021-22,Michigan State,36,23,13,0.639,901,2138,647,1335,254,803,429,606,359,820,1179,463,228,121,373,607,2485,0.421,0.485,0.316,0.708
931,2020-21,Michigan State,28,15,13,0.536,693,1625,517,1077,176,548,429,599,265,694,959,371,181,86,295,498,1991,0.426,0.48,0.321,0.716
932,2019-20,Michigan State,31,22,9,0.71,709,1873,506,1166,203,707,386,549,321,706,1027,395,186,105,341,529,2007,0.379,0.434,0.287,0.703
933,2023-24,Michigan,32,8,24,0.25,926,1988,692,1339,234,649,442,606,347,770,1117,430,245,123,306,541,2528,0.466,0.517,0.361,0.729
934,2022-23,Michigan,34,18,16,0.529,885,2081,662,1378,223,703,374,536,329,871,1200,400,180,89,338,579,2367,0.425,0.48,0.317,0.698
935,2021-22,Michigan,34,19,15,0.559,880,1995,655,1300,225,695,375,511,278,751,1029,377,185,110,338,542,2360,0.441,0.504,0.324,0.734
936,2020-21,Michigan,28,23,5,0.821,667,1698,493,1157,174,541,314,413,254,614,868,280,139,78,281,462,1822,0.393,0.426,0.322,0.76
937,2019-20,Michigan,31,19,12,0.613,799,1888,626,1353,173,535,345,498,291,803,1094,315,143,83,349,494,2116,0.423,0.463,0.323,0.693
938,2023-24,Miami (OH),32,15,17,0.469,800,1870,587,1187,213,683,428,589,339,829,1168,378,206,107,399,559,2241,0.428,0.495,0.312,0.727
939,2022-23,Miami (OH),32,12,20,0.375,840,1819,611,1155,229,664,476,655,332,754,1086,418,247,90,426,557,2385,0.462,0.529,0.345,0.727
940,2021-22,Miami (OH),32,14,18,0.438,839,1883,571,1112,268,771,405,556,325,841,1166,423,199,94,401,524,2351,0.446,0.513,0.348,0.728
941,2020-21,Miami (OH),23,12,11,0.522,598,1335,402,785,196,550,255,360,226,583,809,316,125,85,282,376,1647,0.448,0.512,0.356,0.708
942,2019-20,Miami (OH),32,13,19,0.406,793,1819,543,1109,250,710,439,645,319,868,1187,363,173,103,398,549,2275,0.436,0.49,0.352,0.681
943,2023-24,Miami (FL),32,15,17,0.469,866,1998,560,1078,306,920,318,446,341,803,1144,497,230,110,373,479,2356,0.433,0.519,0.333,0.713
944,2022-23,Miami (FL),37,29,8,0.784,991,2214,706,1362,285,852,394,532,364,824,1188,539,218,125,463,565,2661,0.448,0.518,0.335,0.741
945,2021-22,Miami (FL),37,26,11,0.703,979,2135,694,1309,285,826,360,530,376,932,1308,562,190,125,515,570,2603,0.459,0.53,0.345,0.679
946,2020-21,Miami (FL),27,10,17,0.37,722,1610,474,954,248,656,224,318,245,691,936,401,188,112,331,420,1916,0.448,0.497,0.378,0.704
947,2019-20,Miami (FL),31,15,16,0.484,862,1945,633,1270,229,675,317,445,364,831,1195,471,191,134,384,505,2270,0.443,0.498,0.339,0.712
948,2023-24,Merrimack,33,21,12,0.636,782,1873,596,1281,186,592,409,583,406,846,1252,441,229,103,536,553,2159,0.418,0.465,0.314,0.702
949,2022-23,Merrimack,34,18,16,0.529,791,1862,595,1241,196,621,341,478,397,874,1271,470,227,106,594,556,2119,0.425,0.479,0.316,0.713
950,2021-22,Merrimack,30,14,16,0.467,687,1600,507,1055,180,545,377,530,355,783,1138,411,181,89,447,432,1931,0.429,0.481,0.33,0.711
951,2020-21,Merrimack,18,9,9,0.5,425,1007,309,670,116,337,234,331,200,471,671,246,121,41,269,300,1200,0.422,0.461,0.344,0.707
952,2019-20,Merrimack,31,20,11,0.645,655,1553,509,1069,146,484,408,575,334,806,1140,380,157,109,539,464,1866,0.422,0.476,0.302,0.71
953,2023-24,Mercer,33,16,17,0.485,814,1827,591,1165,223,662,520,719,344,811,1155,366,210,100,403,501,2371,0.446,0.507,0.337,0.723
954,2022-23,Mercer,33,14,19,0.424,774,1798,573,1189,201,609,462,637,302,763,1065,354,187,76,391,514,2211,0.43,0.482,0.33,0.725
955,2021-22,Mercer,33,16,17,0.485,839,1879,569,1098,270,781,380,521,294,768,1062,436,232,87,367,494,2328,0.447,0.518,0.346,0.729
956,2020-21,Mercer,29,18,11,0.621,772,1764,556,1085,216,679,322,457,261,711,972,350,182,74,350,437,2082,0.438,0.512,0.318,0.705
957,2019-20,Mercer,32,17,15,0.531,794,1840,556,1098,238,742,422,638,298,735,1033,407,224,83,409,508,2248,0.432,0.506,0.321,0.661
958,2023-24,Memphis,32,22,10,0.688,855,2001,565,1147,290,854,424,593,406,763,1169,456,230,138,443,591,2424,0.427,0.493,0.34,0.715
959,2022-23,Memphis,35,26,9,0.743,848,2114,569,1207,279,907,537,727,432,802,1234,470,253,141,531,649,2512,0.401,0.471,0.308,0.739
960,2021-22,Memphis,33,22,11,0.667,771,1940,505,1109,266,831,447,644,387,692,1079,438,303,117,479,609,2255,0.397,0.455,0.32,0.694
961,2020-21,Memphis,28,20,8,0.714,606,1557,436,944,170,613,374,549,243,673,916,308,170,86,443,481,1756,0.389,0.462,0.277,0.681
962,2019-20,Memphis,31,21,10,0.677,682,1891,489,1201,193,690,455,662,381,756,1137,358,238,93,461,604,2012,0.361,0.407,0.28,0.687
963,2023-24,McNeese State,34,30,4,0.882,712,1829,433,950,279,879,413,580,363,758,1121,420,157,108,556,610,2116,0.389,0.456,0.317,0.712
964,2022-23,McNeese State,34,11,23,0.324,902,1920,612,1173,290,747,471,660,347,822,1169,562,238,85,443,530,2565,0.47,0.522,0.388,0.714
965,2021-22,McNeese State,33,11,22,0.333,889,1984,653,1295,236,689,541,747,330,811,1141,458,275,99,487,615,2555,0.448,0.504,0.343,0.724
966,2020-21,McNeese State,24,10,14,0.417,635,1423,450,910,185,513,267,401,219,558,777,338,181,84,367,415,1722,0.446,0.495,0.361,0.666
967,2019-20,McNeese State,32,15,17,0.469,855,1984,578,1206,277,778,403,545,360,693,1053,457,249,95,433,578,2390,0.431,0.479,0.356,0.739
968,2023-24,Massachusetts,31,20,11,0.645,739,1755,513,1081,226,674,489,678,333,720,1053,407,193,103,407,567,2193,0.421,0.475,0.335,0.721
969,2022-23,Massachusetts,31,15,16,0.484,779,1794,537,1063,242,731,414,581,303,768,1071,461,240,108,421,579,2214,0.434,0.505,0.331,0.713
970,2021-22,Massachusetts,32,15,17,0.469,920,1896,666,1217,254,679,404,555,315,807,1122,529,190,85,403,552,2498,0.485,0.547,0.374,0.728
971,2020-21,Massachusetts,15,8,7,0.533,403,880,313,614,90,266,199,294,131,424,555,230,105,53,221,280,1095,0.458,0.51,0.338,0.677
972,2019-20,Massachusetts,31,14,17,0.452,806,1762,621,1202,185,560,410,590,317,803,1120,449,220,68,439,559,2207,0.457,0.517,0.33,0.695
973,2023-24,Maryland Eastern Shore,29,9,20,0.31,722,1650,530,1065,192,585,410,602,322,757,1079,356,211,86,395,473,2046,0.438,0.498,0.328,0.681
974,2022-23,Maryland Eastern Shore,31,18,13,0.581,729,1674,532,1063,197,611,399,559,295,762,1057,387,207,99,589,494,2054,0.435,0.5,0.322,0.714
975,2021-22,Maryland Eastern Shore,27,11,16,0.407,628,1453,443,892,185,561,351,512,258,701,959,343,188,85,470,434,1792,0.432,0.497,0.33,0.686
976,2019-20,Maryland Eastern Shore,32,5,27,0.156,796,1790,564,1102,232,688,454,657,334,942,1276,432,235,116,482,478,2278,0.445,0.512,0.337,0.691
977,2023-24,Maryland,33,16,17,0.485,763,1825,583,1276,180,549,468,611,328,819,1147,366,193,119,416,626,2174,0.418,0.457,0.328,0.766
978,2022-23,Maryland,35,22,13,0.629,814,1912,617,1302,197,610,397,543,326,798,1124,384,167,119,417,642,2222,0.426,0.474,0.323,0.731
979,2021-22,Maryland,32,15,17,0.469,826,1909,562,1166,264,743,347,470,314,808,1122,431,180,106,349,578,2263,0.433,0.482,0.355,0.738
980,2020-21,Maryland,31,17,14,0.548,729,1777,473,1035,256,742,320,448,283,769,1052,377,177,84,342,521,2034,0.41,0.457,0.345,0.714
981,2019-20,Maryland,31,24,7,0.774,731,1831,504,1133,227,698,310,444,298,757,1055,400,170,110,362,588,1999,0.399,0.445,0.325,0.698
982,2023-24,Marshall,33,13,20,0.394,922,2060,664,1342,258,718,429,608,349,941,1290,444,247,87,391,534,2531,0.448,0.495,0.359,0.706
983,2022-23,Marshall,32,24,8,0.75,852,2016,630,1323,222,693,355,558,408,825,1233,400,206,54,478,464,2281,0.423,0.476,0.32,0.636
984,2021-22,Marshall,33,12,21,0.364,925,2053,683,1345,242,708,431,555,337,923,1260,420,253,82,439,479,2523,0.451,0.508,0.342,0.777
985,2020-21,Marshall,22,15,7,0.682,587,1351,412,863,175,488,247,372,234,585,819,263,154,60,321,342,1596,0.434,0.477,0.359,0.664
986,2019-20,Marshall,32,17,15,0.531,804,1997,584,1332,220,665,511,740,420,896,1316,333,262,98,493,500,2339,0.403,0.438,0.331,0.691
987,2023-24,Marquette,37,27,10,0.73,919,2156,608,1233,311,923,434,580,397,929,1326,546,211,114,544,540,2583,0.426,0.493,0.337,0.748
988,2022-23,Marquette,36,29,7,0.806,919,2067,650,1291,269,776,423,602,385,891,1276,534,204,119,570,550,2530,0.445,0.503,0.347,0.703
989,2021-22,Marquette,32,19,13,0.594,824,1999,594,1280,230,719,414,589,399,863,1262,463,224,102,437,484,2292,0.412,0.464,0.32,0.703
990,2020-21,Marquette,27,13,14,0.481,666,1609,464,1013,202,596,351,483,285,628,913,362,197,86,294,481,1885,0.414,0.458,0.339,0.727
991,2019-20,Marquette,30,18,12,0.6,758,1839,551,1197,207,642,426,641,305,746,1051,394,201,92,329,582,2149,0.412,0.46,0.322,0.665
992,2023-24,Marist,31,18,13,0.581,670,1633,471,1007,199,626,389,572,284,745,1029,294,209,79,417,477,1928,0.41,0.468,0.318,0.68
993,2022-23,Marist,33,13,20,0.394,782,1893,533,1182,249,711,386,538,341,843,1184,381,190,88,365,508,2201,0.413,0.451,0.35,0.717
994,2021-22,Marist,30,14,16,0.467,723,1742,485,1029,238,713,361,496,292,762,1054,396,179,96,341,472,2045,0.415,0.471,0.334,0.728
995,2020-21,Marist,21,12,9,0.571,460,1174,306,675,154,499,262,378,197,530,727,250,142,59,255,369,1336,0.392,0.453,0.309,0.693
996,2019-20,Marist,30,7,23,0.233,650,1551,422,885,228,666,442,607,247,792,1039,376,196,69,412,506,1970,0.419,0.477,0.342,0.728
997,2023-24,Manhattan,30,7,23,0.233,847,1827,620,1210,227,617,354,482,313,826,1139,509,243,122,356,413,2275,0.464,0.512,0.368,0.734
998,2022-23,Manhattan,30,12,18,0.4,759,1723,531,1095,228,628,364,517,340,745,1085,423,227,92,426,476,2112,0.441,0.485,0.363,0.704
999,2021-22,Manhattan,30,15,15,0.5,786,1702,596,1136,190,566,417,590,308,702,1010,441,228,78,435,581,2179,0.462,0.525,0.336,0.707
1000,2020-21,Manhattan,20,7,13,0.35,443,1044,329,699,114,345,345,489,197,541,738,246,121,82,311,405,1345,0.424,0.471,0.33,0.706
1001,2019-20,Manhattan,31,13,18,0.419,658,1576,478,1054,180,522,495,725,310,797,1107,376,197,94,461,586,1991,0.418,0.454,0.345,0.683
1002,2023-24,Maine,32,15,17,0.469,789,1794,602,1205,187,589,394,575,296,837,1133,411,202,112,422,487,2159,0.44,0.5,0.317,0.685
1003,2022-23,Maine,30,13,17,0.433,773,1671,563,1059,210,612,335,468,279,750,1029,402,176,94,418,383,2091,0.463,0.532,0.343,0.716
1004,2021-22,Maine,29,6,23,0.207,738,1577,529,1018,209,559,378,518,265,766,1031,366,190,74,375,389,2063,0.468,0.52,0.374,0.73
1005,2020-21,Maine,9,2,7,0.222,208,487,149,297,59,190,106,151,92,227,319,107,74,19,122,140,581,0.427,0.502,0.311,0.702
1006,2019-20,Maine,31,9,22,0.29,725,1708,480,940,245,768,414,549,290,754,1044,394,235,73,385,476,2109,0.424,0.511,0.319,0.754
1007,2023-24,Loyola Marymount,31,12,19,0.387,814,1817,617,1239,197,578,389,533,282,727,1009,417,179,110,264,483,2214,0.448,0.498,0.341,0.73
1008,2022-23,Loyola Marymount,31,19,12,0.613,809,1773,607,1172,202,601,445,616,251,732,983,371,160,86,354,577,2265,0.456,0.518,0.336,0.722
1009,2021-22,Loyola Marymount,29,11,18,0.379,770,1605,557,1014,213,591,395,507,238,700,938,425,187,100,366,539,2148,0.48,0.549,0.36,0.779
1010,2020-21,Loyola Marymount,22,13,9,0.591,526,1182,377,750,149,432,295,411,143,457,600,287,150,73,259,433,1496,0.445,0.503,0.345,0.718
1011,2019-20,Loyola Marymount,32,11,21,0.344,729,1660,483,907,246,753,464,630,273,666,939,428,215,109,393,576,2168,0.439,0.533,0.327,0.737
1012,2023-24,Loyola Chicago,33,23,10,0.697,747,1858,519,1190,228,668,506,687,296,812,1108,370,220,137,414,567,2228,0.402,0.436,0.341,0.737
1013,2022-23,Loyola Chicago,31,10,21,0.323,769,1705,546,1056,223,649,486,640,290,717,1007,394,249,97,376,526,2247,0.451,0.517,0.344,0.759
1014,2021-22,Loyola Chicago,33,25,8,0.758,725,1770,515,1090,210,680,369,504,262,768,1030,303,190,117,446,564,2029,0.41,0.472,0.309,0.732
1015,2020-21,Loyola Chicago,31,26,5,0.839,657,1591,487,1069,170,522,254,356,196,657,853,298,158,84,428,509,1738,0.413,0.456,0.326,0.713
1016,2019-20,Loyola Chicago,32,21,11,0.656,739,1677,472,951,267,726,262,392,237,736,973,399,198,114,502,570,2007,0.441,0.496,0.368,0.668
1017,2023-24,Loyola (MD),32,7,25,0.219,831,1785,595,1126,236,659,403,577,267,782,1049,431,234,118,331,536,2301,0.466,0.528,0.358,0.698
1018,2022-23,Loyola (MD),33,13,20,0.394,862,1804,623,1146,239,658,368,520,285,797,1082,468,224,89,452,536,2331,0.478,0.544,0.363,0.708
1019,2021-22,Loyola (MD),30,14,16,0.467,709,1606,503,1000,206,606,346,481,251,750,1001,388,194,84,421,437,1970,0.441,0.503,0.34,0.719
1020,2020-21,Loyola (MD),17,6,11,0.353,421,981,295,618,126,363,238,328,154,419,573,216,137,51,234,332,1206,0.429,0.477,0.347,0.726
1021,2019-20,Loyola (MD),32,15,17,0.469,849,1932,601,1169,248,763,448,619,337,804,1141,475,215,101,412,643,2394,0.439,0.514,0.325,0.724
1022,2023-24,Louisville,32,8,24,0.25,894,1890,619,1150,275,740,467,638,297,812,1109,494,242,123,366,608,2530,0.473,0.538,0.372,0.732
1023,2022-23,Louisville,32,4,28,0.125,877,1862,617,1123,260,739,411,569,316,748,1064,492,224,112,325,536,2425,0.471,0.549,0.352,0.722
1024,2021-22,Louisville,32,13,19,0.406,805,1842,560,1140,245,702,388,552,280,850,1130,422,205,101,354,484,2243,0.437,0.491,0.349,0.703
1025,2020-21,Louisville,20,13,7,0.65,482,1141,341,678,141,463,225,340,191,478,669,240,117,72,221,345,1330,0.422,0.503,0.305,0.662
1026,2019-20,Louisville,31,24,7,0.774,690,1772,471,1045,219,727,375,514,287,713,1000,326,187,100,365,528,1974,0.389,0.451,0.301,0.73
1027,2023-24,Louisiana–Monroe,30,11,19,0.367,747,1718,474,942,273,776,466,632,306,741,1047,439,208,112,368,549,2233,0.435,0.503,0.352,0.737
1028,2022-23,Louisiana–Monroe,32,11,21,0.344,804,1838,554,1116,250,722,377,510,317,817,1134,434,204,117,405,515,2235,0.437,0.496,0.346,0.739
1029,2021-22,Louisiana–Monroe,31,13,18,0.419,815,1813,555,1082,260,731,414,599,354,794,1148,469,228,120,438,482,2304,0.45,0.513,0.356,0.691
1030,2020-21,Louisiana–Monroe,26,7,19,0.269,626,1432,435,909,191,523,349,487,274,698,972,328,169,76,375,395,1792,0.437,0.479,0.365,0.717
1031,2019-20,Louisiana–Monroe,29,9,20,0.31,685,1639,489,1017,196,622,390,550,305,704,1009,359,175,75,333,489,1956,0.418,0.481,0.315,0.709
1032,2023-24,Louisiana Tech,32,22,10,0.688,716,1832,494,1166,222,666,411,579,336,715,1051,326,222,95,406,589,2065,0.391,0.424,0.333,0.71
1033,2022-23,Louisiana Tech,33,15,18,0.455,789,1771,510,1019,279,752,463,661,301,776,1077,466,226,116,502,530,2320,0.446,0.5,0.371,0.7
1034,2021-22,Louisiana Tech,34,24,10,0.706,830,2010,570,1226,260,784,392,536,341,874,1215,420,218,103,463,585,2312,0.413,0.465,0.332,0.731
1035,2020-21,Louisiana Tech,32,24,8,0.75,755,1873,534,1147,221,726,363,508,291,831,1122,383,194,103,436,578,2094,0.403,0.466,0.304,0.715
1036,2019-20,Louisiana Tech,30,22,8,0.733,667,1676,459,1009,208,667,368,524,305,722,1027,332,150,93,444,489,1910,0.398,0.455,0.312,0.702
1037,2023-24,Louisiana State,33,17,16,0.515,848,1981,573,1160,275,821,503,667,380,778,1158,413,271,133,426,567,2474,0.428,0.494,0.335,0.754
1038,2022-23,Louisiana State,33,14,19,0.424,831,1859,566,1086,265,773,407,564,316,809,1125,432,199,119,384,541,2334,0.447,0.521,0.343,0.722
1039,2021-22,Louisiana State,34,22,12,0.647,715,1854,472,991,243,863,483,700,379,803,1182,389,244,117,605,567,2156,0.386,0.476,0.282,0.69
1040,2020-21,Louisiana State,29,19,10,0.655,773,1844,530,1033,243,811,392,549,368,727,1095,400,168,106,379,526,2181,0.419,0.513,0.3,0.714
1041,2019-20,Louisiana State,31,21,10,0.677,821,1941,544,1137,277,804,352,512,341,694,1035,397,178,102,368,549,2271,0.423,0.478,0.345,0.688
1042,2023-24,Louisiana,33,19,14,0.576,834,1856,671,1266,163,590,534,741,363,807,1170,366,229,127,487,520,2365,0.449,0.53,0.276,0.721
1043,2022-23,Louisiana,34,26,8,0.765,859,1944,660,1352,199,592,445,633,302,733,1035,362,225,107,428,621,2362,0.442,0.488,0.336,0.703
1044,2021-22,Louisiana,31,16,15,0.516,747,1820,553,1218,194,602,463,623,311,740,1051,375,257,98,406,578,2151,0.41,0.454,0.322,0.743
1045,2020-21,Louisiana,26,17,9,0.654,684,1614,515,1107,169,507,355,474,267,627,894,361,178,82,315,428,1892,0.424,0.465,0.333,0.749
1046,2019-20,Louisiana,33,14,19,0.424,896,1988,648,1258,248,730,474,648,340,853,1193,448,234,96,459,617,2514,0.451,0.515,0.34,0.731
1047,2023-24,Longwood,35,21,14,0.6,837,1902,573,1141,264,761,458,667,284,757,1041,416,223,103,477,679,2396,0.44,0.502,0.347,0.687
1048,2022-23,Longwood,32,20,12,0.625,737,1693,486,971,251,722,394,549,271,738,1009,389,189,106,462,546,2119,0.435,0.501,0.348,0.718
1049,2021-22,Longwood,33,26,7,0.788,788,1817,535,1027,253,790,341,462,250,754,1004,394,191,123,467,601,2170,0.434,0.521,0.32,0.738
1050,2020-21,Longwood,29,12,17,0.414,692,1539,480,859,212,680,370,509,252,715,967,342,183,97,394,494,1966,0.45,0.559,0.312,0.727
1051,2019-20,Longwood,32,14,18,0.438,760,1765,496,1005,264,760,411,605,275,882,1157,437,194,107,449,583,2195,0.431,0.494,0.347,0.679
1052,2023-24,Long Beach State,36,21,15,0.583,951,2205,616,1238,335,967,498,689,389,900,1289,561,255,98,491,728,2735,0.431,0.498,0.346,0.723
1053,2022-23,Long Beach State,33,17,16,0.515,867,2056,591,1236,276,820,445,609,350,798,1148,477,249,104,463,615,2455,0.422,0.478,0.337,0.731
1054,2021-22,Long Beach State,33,20,13,0.606,872,1961,606,1190,266,771,399,537,301,843,1144,464,211,93,479,641,2409,0.445,0.509,0.345,0.743
1055,2020-21,Long Beach State,18,6,12,0.333,497,1159,346,718,151,441,285,405,222,488,710,250,136,53,242,351,1430,0.429,0.482,0.342,0.704
1056,2019-20,Long Beach State,32,11,21,0.344,859,1943,583,1153,276,790,410,577,359,825,1184,499,256,83,462,589,2404,0.442,0.506,0.349,0.711
1057,2023-24,LIU,29,7,22,0.241,779,1713,596,1125,183,588,486,703,299,798,1097,428,251,121,330,462,2227,0.455,0.53,0.311,0.691
1058,2022-23,LIU,29,3,26,0.103,854,1795,626,1164,228,631,383,566,306,780,1086,504,254,112,371,491,2319,0.476,0.538,0.361,0.677
1059,2021-22,LIU,30,16,14,0.533,777,1884,529,1099,248,785,402,561,345,807,1152,399,212,82,411,496,2204,0.412,0.481,0.316,0.717
1060,2020-21,LIU,18,9,9,0.5,485,1095,362,711,123,384,220,311,185,489,674,253,119,52,280,320,1313,0.443,0.509,0.32,0.707
1061,2019-20,LIU,33,15,18,0.455,930,2114,676,1353,254,761,420,591,383,929,1312,476,210,115,462,592,2534,0.44,0.5,0.334,0.711
1062,2023-24,Little Rock,34,21,13,0.618,844,2012,595,1240,249,772,527,711,377,788,1165,412,192,101,425,576,2464,0.419,0.48,0.323,0.741
1063,2022-23,Little Rock,31,10,21,0.323,870,1829,600,1140,270,689,451,678,322,802,1124,458,194,116,441,567,2461,0.476,0.526,0.392,0.665
1064,2021-22,Little Rock,28,9,19,0.321,743,1579,512,957,231,622,330,471,266,716,982,425,174,73,404,478,2047,0.471,0.535,0.371,0.701
1065,2020-21,Little Rock,26,11,15,0.423,645,1476,444,895,201,581,291,402,241,579,820,347,172,77,362,486,1782,0.437,0.496,0.346,0.724
1066,2019-20,Little Rock,31,21,10,0.677,750,1769,512,1082,238,687,414,595,310,692,1002,377,210,99,430,650,2152,0.424,0.473,0.346,0.696
1067,2023-24,Lipscomb,32,20,12,0.625,926,2015,658,1261,268,754,328,459,324,791,1115,387,164,114,369,493,2448,0.46,0.522,0.355,0.715
1068,2022-23,Lipscomb,33,20,13,0.606,866,2024,601,1230,265,794,346,466,288,806,1094,357,202,90,383,481,2343,0.428,0.489,0.334,0.742
1069,2021-22,Lipscomb,33,14,19,0.424,932,2150,610,1272,322,878,350,484,356,838,1194,482,233,137,330,558,2536,0.433,0.48,0.367,0.723
1070,2020-21,Lipscomb,27,15,12,0.556,695,1606,476,921,219,685,239,340,256,675,931,343,159,82,347,434,1848,0.433,0.517,0.32,0.703
1071,2019-20,Lipscomb,32,16,16,0.5,829,1883,563,1122,266,761,337,493,307,804,1111,405,192,125,398,499,2261,0.44,0.502,0.35,0.684
1072,2023-24,Lindenwood,31,9,22,0.29,781,1691,540,1044,241,647,463,640,281,838,1119,400,192,118,388,569,2266,0.462,0.517,0.372,0.723
1073,2022-23,Lindenwood,32,11,21,0.344,847,1918,574,1119,273,799,395,570,343,862,1205,457,222,99,412,494,2362,0.442,0.513,0.342,0.693
1074,2023-24,Liberty,32,18,14,0.563,775,1769,596,1198,179,571,367,506,252,790,1042,312,187,114,372,505,2096,0.438,0.497,0.313,0.725
1075,2022-23,Liberty,36,27,9,0.75,792,1891,562,1202,230,689,380,518,239,850,1089,327,205,92,468,569,2194,0.419,0.468,0.334,0.734
1076,2021-22,Liberty,33,22,11,0.667,729,1809,489,1073,240,736,396,550,252,785,1037,347,209,71,383,497,2094,0.403,0.456,0.326,0.72
1077,2020-21,Liberty,29,23,6,0.793,634,1550,463,995,171,555,300,435,206,660,866,264,156,64,341,407,1739,0.409,0.465,0.308,0.69
1078,2019-20,Liberty,34,30,4,0.882,657,1697,462,1029,195,668,321,464,237,759,996,294,157,60,408,548,1830,0.387,0.449,0.292,0.692
1079,2023-24,Lehigh,32,14,18,0.438,828,1880,588,1185,240,695,376,541,262,888,1150,388,209,115,410,545,2272,0.44,0.496,0.345,0.695
1080,2022-23,Lehigh,30,16,14,0.533,769,1778,569,1158,200,620,344,505,279,805,1084,367,176,90,353,462,2082,0.433,0.491,0.323,0.681
1081,2021-22,Lehigh,32,13,19,0.406,839,1899,665,1409,174,490,432,599,292,829,1121,342,241,129,325,476,2284,0.442,0.472,0.355,0.721
1082,2020-21,Lehigh,15,4,11,0.267,412,879,301,576,111,303,214,288,120,413,533,212,106,49,182,241,1149,0.469,0.523,0.366,0.743
1083,2019-20,Lehigh,32,11,21,0.344,825,1869,565,1080,260,789,429,599,291,790,1081,460,221,110,385,494,2339,0.441,0.523,0.33,0.716
1084,2023-24,Le Moyne,32,15,17,0.469,811,1916,538,1087,273,829,350,492,355,870,1225,459,200,76,424,444,2245,0.423,0.495,0.329,0.711
1085,2023-24,Lamar,33,19,14,0.576,808,1919,551,1152,257,767,533,756,377,784,1161,473,240,101,463,613,2406,0.421,0.478,0.335,0.705
1086,2022-23,Lamar,31,9,22,0.29,827,1852,548,1033,279,819,378,564,376,734,1110,531,251,118,382,519,2311,0.447,0.53,0.341,0.67
1087,2021-22,Lamar,29,2,27,0.069,722,1621,486,941,236,680,436,618,307,738,1045,483,215,86,347,462,2116,0.445,0.516,0.347,0.706
1088,2020-21,Lamar,28,10,18,0.357,747,1645,521,1061,226,584,306,452,281,749,1030,420,195,92,394,474,2026,0.454,0.491,0.387,0.677
1089,2019-20,Lamar,32,17,15,0.531,818,1893,578,1187,240,706,351,504,372,810,1182,443,224,112,546,593,2227,0.432,0.487,0.34,0.696
1090,2023-24,Lafayette,32,11,21,0.344,752,1801,515,1109,237,692,413,559,323,861,1184,387,201,99,376,471,2154,0.418,0.464,0.342,0.739
1091,2022-23,Lafayette,34,11,23,0.324,800,1826,543,1073,257,753,375,537,283,911,1194,442,212,89,403,491,2232,0.438,0.506,0.341,0.698
1092,2021-22,Lafayette,30,10,20,0.333,814,1763,576,1121,238,642,319,461,305,812,1117,421,169,72,346,412,2185,0.462,0.514,0.371,0.692
1093,2020-21,Lafayette,15,9,6,0.6,422,919,330,642,92,277,214,310,156,428,584,202,76,45,174,263,1150,0.459,0.514,0.332,0.69
1094,2019-20,Lafayette,31,19,12,0.613,816,1909,603,1226,213,683,288,424,313,781,1094,355,178,60,297,432,2133,0.427,0.492,0.312,0.679
1095,2023-24,La Salle,33,16,17,0.485,866,1942,643,1309,223,633,456,636,351,884,1235,443,165,118,357,504,2411,0.446,0.491,0.352,0.717
1096,2022-23,La Salle,34,15,19,0.441,898,1996,658,1300,240,696,432,630,365,874,1239,455,203,152,422,571,2468,0.45,0.506,0.345,0.686
1097,2021-22,La Salle,30,11,19,0.367,764,1762,532,1117,232,645,386,546,293,799,1092,431,197,87,349,469,2146,0.434,0.476,0.36,0.707
1098,2020-21,La Salle,25,9,16,0.36,645,1418,470,884,175,534,373,502,243,638,881,367,180,73,342,362,1838,0.455,0.532,0.328,0.743
1099,2019-20,La Salle,30,15,15,0.5,716,1670,529,1047,187,623,479,669,291,776,1067,394,247,119,427,533,2098,0.429,0.505,0.3,0.716
1100,2023-24,Kentucky,33,23,10,0.697,917,2138,632,1279,285,859,511,715,398,817,1215,479,211,116,391,562,2630,0.429,0.494,0.332,0.715
1101,2022-23,Kentucky,34,22,12,0.647,827,1929,605,1244,222,685,429,577,290,732,1022,399,205,75,379,580,2305,0.429,0.486,0.324,0.744
1102,2021-22,Kentucky,34,26,8,0.765,835,2018,612,1295,223,723,370,513,306,728,1034,391,204,100,414,547,2263,0.414,0.473,0.308,0.721
1103,2020-21,Kentucky,25,9,16,0.36,628,1521,464,996,164,525,334,451,286,619,905,307,154,91,317,456,1754,0.413,0.466,0.312,0.741
1104,2019-20,Kentucky,31,25,6,0.806,717,1819,503,1122,214,697,401,583,333,673,1006,335,155,98,372,606,2049,0.394,0.448,0.307,0.688
1105,2023-24,Kent State,34,17,17,0.5,850,1901,603,1144,247,757,477,656,323,809,1132,430,216,105,450,590,2424,0.447,0.527,0.326,0.727
1106,2022-23,Kent State,35,28,7,0.8,777,1920,535,1142,242,778,509,706,365,858,1223,397,188,101,551,645,2305,0.405,0.468,0.311,0.721
1107,2021-22,Kent State,34,23,11,0.676,755,1833,504,1029,251,804,456,654,300,779,1079,399,217,81,458,582,2217,0.412,0.49,0.312,0.697
1108,2020-21,Kent State,23,15,8,0.652,585,1385,395,835,190,550,275,390,235,541,776,294,154,60,300,391,1635,0.422,0.473,0.345,0.705
1109,2019-20,Kent State,32,20,12,0.625,779,1879,545,1180,234,699,449,622,347,779,1126,404,169,68,453,563,2241,0.415,0.462,0.335,0.722
1110,2023-24,Kennesaw State,31,15,16,0.484,841,1916,582,1174,259,742,563,782,345,856,1201,401,217,138,418,601,2504,0.439,0.496,0.349,0.72
1111,2022-23,Kennesaw State,35,26,9,0.743,842,1957,591,1199,251,758,480,698,315,873,1188,399,231,106,502,675,2415,0.43,0.493,0.331,0.688
1112,2021-22,Kennesaw State,31,13,18,0.419,773,1750,517,1040,256,710,404,578,286,742,1028,409,197,81,421,540,2206,0.442,0.497,0.361,0.699
1113,2020-21,Kennesaw State,24,5,19,0.208,606,1341,464,893,142,448,318,440,185,629,814,250,166,58,306,417,1672,0.452,0.52,0.317,0.723
1114,2019-20,Kennesaw State,29,1,28,0.034,806,1670,572,1040,234,630,335,508,295,804,1099,419,185,116,365,507,2181,0.483,0.55,0.371,0.659
1115,2023-24,Kansas State,34,19,15,0.559,849,2068,612,1309,237,759,482,684,394,788,1182,450,283,121,382,625,2417,0.411,0.468,0.312,0.705
1116,2022-23,Kansas State,36,26,10,0.722,878,2070,643,1306,235,764,524,751,388,833,1221,493,259,140,541,659,2515,0.424,0.492,0.308,0.698
1117,2021-22,Kansas State,31,14,17,0.452,749,1724,540,1031,209,693,384,551,298,814,1112,412,177,108,417,483,2091,0.434,0.524,0.302,0.697
1118,2020-21,Kansas State,29,9,20,0.31,720,1566,488,930,232,636,365,494,256,699,955,392,227,90,386,442,2037,0.46,0.525,0.365,0.739
1119,2019-20,Kansas State,32,11,21,0.344,707,1646,489,986,218,660,447,638,311,787,1098,374,241,128,525,562,2079,0.43,0.496,0.33,0.701
1120,2023-24,Kansas City,32,16,16,0.5,746,1705,542,1068,204,637,521,734,276,758,1034,370,189,83,405,554,2217,0.438,0.507,0.32,0.71
1121,2022-23,Kansas City,32,11,21,0.344,734,1730,495,1033,239,697,492,662,317,748,1065,349,196,102,380,524,2199,0.424,0.479,0.343,0.743
1122,2021-22,Kansas City,31,19,12,0.613,703,1595,524,1034,179,561,500,670,211,817,1028,339,152,106,483,532,2085,0.441,0.507,0.319,0.746
1123,2020-21,Kansas City,24,11,13,0.458,484,1118,348,700,136,418,398,577,175,546,721,259,127,74,378,392,1502,0.433,0.497,0.325,0.69
1124,2019-20,Kansas City,30,16,14,0.533,649,1516,497,1005,152,511,526,695,265,741,1006,323,174,127,455,486,1976,0.428,0.495,0.297,0.757
1125,2023-24,Kansas,34,23,11,0.676,842,2055,553,1206,289,849,403,579,338,809,1147,438,231,94,395,549,2376,0.41,0.459,0.34,0.696
1126,2022-23,Kansas,36,28,8,0.778,873,2103,643,1361,230,742,474,654,379,876,1255,406,220,101,515,577,2450,0.415,0.472,0.31,0.725
1127,2021-22,Kansas,40,34,6,0.85,980,2411,730,1573,250,838,480,668,429,895,1324,473,261,128,507,695,2690,0.406,0.464,0.298,0.719
1128,2020-21,Kansas,30,21,9,0.7,725,1749,503,1088,222,661,336,466,279,759,1038,351,180,89,417,496,2010,0.415,0.462,0.336,0.721
1129,2019-20,Kansas,31,28,3,0.903,684,1815,455,1065,229,750,285,423,308,683,991,361,199,111,407,526,1882,0.377,0.427,0.305,0.674
1130,2023-24,James Madison,36,32,4,0.889,878,2112,653,1359,225,753,525,721,358,863,1221,385,214,123,516,621,2506,0.416,0.481,0.299,0.728
1131,2022-23,James Madison,33,22,11,0.667,811,1920,585,1191,226,729,398,590,322,806,1128,383,238,104,546,645,2246,0.422,0.491,0.31,0.675
1132,2021-22,James Madison,29,15,14,0.517,763,1724,504,935,259,789,338,456,313,730,1043,445,179,81,446,499,2123,0.443,0.539,0.328,0.741
1133,2020-21,James Madison,20,13,7,0.65,480,1165,310,625,170,540,279,374,212,529,741,265,119,64,321,397,1409,0.412,0.496,0.315,0.746
1134,2019-20,James Madison,30,9,21,0.3,820,1850,548,1076,272,774,384,528,290,852,1142,430,174,102,350,536,2296,0.443,0.509,0.351,0.727
1135,2023-24,Jacksonville State,32,14,18,0.438,752,1735,543,1116,209,619,413,588,262,721,983,348,226,99,401,564,2126,0.433,0.487,0.338,0.702
1136,2022-23,Jacksonville State,31,13,18,0.419,762,1749,475,921,287,828,367,496,265,729,994,432,190,75,357,530,2178,0.436,0.516,0.347,0.74
1137,2021-22,Jacksonville State,32,21,11,0.656,778,1901,496,1051,282,850,313,411,311,736,1047,421,202,86,379,498,2151,0.409,0.472,0.332,0.762
1138,2020-21,Jacksonville State,27,18,9,0.667,675,1642,452,958,223,684,278,412,287,628,915,354,166,72,307,447,1851,0.411,0.472,0.326,0.675
1139,2019-20,Jacksonville State,32,13,19,0.406,818,1812,593,1122,225,690,357,516,268,773,1041,438,209,99,453,523,2218,0.451,0.529,0.326,0.692
1140,2023-24,Jacksonville,33,16,17,0.485,811,1853,556,1115,255,738,512,723,335,724,1059,411,235,112,417,583,2389,0.438,0.499,0.346,0.708
1141,2022-23,Jacksonville,29,13,16,0.448,642,1576,401,811,241,765,291,399,247,654,901,352,171,81,277,365,1816,0.407,0.494,0.315,0.729
1142,2021-22,Jacksonville,31,21,10,0.677,641,1617,426,888,215,729,342,475,233,665,898,312,166,103,355,451,1839,0.396,0.48,0.295,0.72
1143,2020-21,Jacksonville,24,11,13,0.458,615,1400,433,848,182,552,256,370,242,624,866,312,153,61,351,433,1668,0.439,0.511,0.33,0.692
1144,2019-20,Jacksonville,32,14,18,0.438,766,1894,545,1158,221,736,380,533,306,794,1100,340,214,101,344,508,2133,0.404,0.471,0.3,0.713
1145,2023-24,Jackson State,32,15,17,0.469,849,1862,589,1124,260,738,460,642,350,779,1129,466,234,122,427,559,2418,0.456,0.524,0.352,0.717
1146,2022-23,Jackson State,33,14,19,0.424,853,1881,594,1140,259,741,464,637,311,775,1086,446,262,140,448,545,2429,0.453,0.521,0.35,0.728
1147,2021-22,Jackson State,30,11,19,0.367,699,1627,544,1146,155,481,411,595,278,734,1012,338,198,104,363,436,1964,0.43,0.475,0.322,0.691
1148,2020-21,Jackson State,18,12,6,0.667,385,978,301,701,84,277,277,402,171,460,631,174,119,58,283,334,1131,0.394,0.429,0.303,0.689
1149,2019-20,Jackson State,32,15,17,0.469,731,1701,545,1147,186,554,509,719,288,838,1126,373,186,101,520,563,2157,0.43,0.475,0.336,0.708
1150,2023-24,IUPUI,32,6,26,0.188,927,1828,669,1143,258,685,442,610,337,727,1064,513,235,102,432,534,2554,0.507,0.585,0.377,0.725
1151,2022-23,IUPUI,32,5,27,0.156,860,1833,604,1119,256,714,480,632,337,718,1055,469,267,102,372,532,2456,0.469,0.54,0.359,0.759
1152,2021-22,IUPUI,29,3,26,0.103,666,1494,449,879,217,615,398,536,285,666,951,352,221,87,383,424,1947,0.446,0.511,0.353,0.743
1153,2020-21,IUPUI,18,8,10,0.444,493,1039,383,678,110,361,268,365,149,493,642,232,122,38,247,288,1364,0.474,0.565,0.305,0.734
1154,2019-20,IUPUI,32,7,25,0.219,933,2013,646,1232,287,781,411,570,372,876,1248,512,228,125,406,567,2564,0.463,0.524,0.367,0.721
1155,2023-24,Iowa State,37,29,8,0.784,768,1909,496,1046,272,863,469,664,357,870,1227,451,224,130,636,674,2277,0.402,0.474,0.315,0.706
1156,2022-23,Iowa State,33,19,14,0.576,671,1598,419,851,252,747,473,652,264,741,1005,388,224,97,546,561,2067,0.42,0.492,0.337,0.725
1157,2021-22,Iowa State,35,22,13,0.629,760,1790,563,1109,197,681,472,657,314,850,1164,407,255,141,582,596,2189,0.425,0.508,0.289,0.718
1158,2020-21,Iowa State,24,2,22,0.083,652,1408,493,926,159,482,378,510,273,640,913,318,194,78,312,333,1841,0.463,0.532,0.33,0.741
1159,2019-20,Iowa State,32,12,20,0.375,858,1899,607,1200,251,699,368,532,355,791,1146,425,231,94,467,527,2335,0.452,0.506,0.359,0.692
1160,2023-24,Iowa,34,19,15,0.559,969,2114,697,1354,272,760,490,696,381,881,1262,523,202,127,408,591,2700,0.458,0.515,0.358,0.704
1161,2022-23,Iowa,33,19,14,0.576,939,1982,705,1342,234,640,352,472,305,840,1145,478,189,115,424,598,2464,0.474,0.525,0.366,0.746
1162,2021-22,Iowa,36,26,10,0.722,949,2170,690,1382,259,788,405,570,390,903,1293,518,189,104,490,641,2562,0.437,0.499,0.329,0.711
1163,2020-21,Iowa,31,22,9,0.71,840,2002,565,1212,275,790,300,444,357,789,1146,506,166,98,355,574,2255,0.42,0.466,0.348,0.676
1164,2019-20,Iowa,31,20,11,0.645,815,1895,572,1137,243,758,368,507,338,757,1095,479,192,115,384,589,2241,0.43,0.503,0.321,0.726
1165,2023-24,Iona,33,16,17,0.485,804,1746,567,1048,237,698,484,655,317,872,1189,454,183,127,502,497,2329,0.46,0.541,0.34,0.739
1166,2022-23,Iona,35,27,8,0.771,826,2009,619,1313,207,696,438,621,380,843,1223,426,187,97,503,564,2297,0.411,0.471,0.297,0.705
1167,2021-22,Iona,33,25,8,0.758,804,1934,610,1292,194,642,462,654,357,807,1164,381,234,105,443,626,2264,0.416,0.472,0.302,0.706
1168,2020-21,Iona,18,12,6,0.667,388,963,279,602,109,361,304,444,168,409,577,207,135,46,247,347,1189,0.403,0.463,0.302,0.685
1169,2019-20,Iona,29,12,17,0.414,718,1700,476,1034,242,666,377,581,343,689,1032,419,198,83,376,509,2055,0.422,0.46,0.363,0.649
1170,2023-24,Indiana State,39,32,7,0.821,1055,2406,773,1587,282,819,462,624,338,907,1245,424,241,130,437,665,2854,0.438,0.487,0.344,0.74
1171,2022-23,Indiana State,36,23,13,0.639,902,2117,661,1365,241,752,462,631,288,886,1174,360,215,121,450,581,2507,0.426,0.484,0.32,0.732
1172,2021-22,Indiana State,31,11,20,0.355,819,1865,578,1185,241,680,351,467,243,840,1083,389,200,103,353,467,2230,0.439,0.488,0.354,0.752
1173,2020-21,Indiana State,25,15,10,0.6,607,1347,433,835,174,512,257,368,212,620,832,332,129,66,367,444,1645,0.451,0.519,0.34,0.698
1174,2019-20,Indiana State,30,18,12,0.6,723,1618,533,1023,190,595,368,527,248,739,987,377,153,82,382,543,2004,0.447,0.521,0.319,0.698
1175,2023-24,Indiana,33,19,14,0.576,845,2013,561,1184,284,829,478,637,363,793,1156,447,247,101,341,611,2452,0.42,0.474,0.343,0.75
1176,2022-23,Indiana,35,23,12,0.657,852,2084,589,1297,263,787,437,621,379,820,1199,408,229,111,391,561,2404,0.409,0.454,0.334,0.704
1177,2021-22,Indiana,35,21,14,0.6,793,2004,528,1201,265,803,465,615,317,858,1175,378,231,94,422,603,2316,0.396,0.44,0.33,0.756
1178,2020-21,Indiana,27,12,15,0.444,655,1539,462,961,193,578,370,516,260,713,973,319,159,98,330,534,1873,0.426,0.481,0.334,0.717
1179,2019-20,Indiana,32,20,12,0.625,754,1809,529,1111,225,698,402,589,276,753,1029,387,199,107,392,604,2135,0.417,0.476,0.322,0.683
1180,2023-24,Incarnate Word,31,8,23,0.258,841,1871,613,1232,228,639,526,740,335,765,1100,444,261,120,346,545,2436,0.449,0.498,0.357,0.711
1181,2022-23,Incarnate Word,31,12,19,0.387,832,1759,618,1159,214,600,412,575,319,769,1088,406,222,89,455,525,2290,0.473,0.533,0.357,0.717
1182,2021-22,Incarnate Word,32,7,25,0.219,910,1836,671,1179,239,657,386,544,313,821,1134,444,212,76,407,527,2445,0.496,0.569,0.364,0.71
1183,2020-21,Incarnate Word,22,8,14,0.364,586,1264,460,852,126,412,280,408,227,542,769,313,147,67,283,385,1578,0.464,0.54,0.306,0.686
1184,2019-20,Incarnate Word,31,9,22,0.29,812,1783,598,1159,214,624,454,602,338,783,1121,476,206,113,448,528,2292,0.455,0.516,0.343,0.754
1185,2023-24,Illinois–Chicago,33,12,21,0.364,818,1920,606,1252,212,668,513,683,330,886,1216,427,219,119,402,478,2361,0.426,0.484,0.317,0.751
1186,2022-23,Illinois–Chicago,32,12,20,0.375,823,1841,608,1208,215,633,431,599,328,896,1224,453,194,119,443,562,2292,0.447,0.503,0.34,0.72
1187,2021-22,Illinois–Chicago,30,14,16,0.467,798,1737,624,1265,174,472,418,580,268,798,1066,346,203,63,361,439,2188,0.459,0.493,0.369,0.721
1188,2020-21,Illinois–Chicago,22,9,13,0.409,587,1333,480,977,107,356,310,452,219,599,818,261,141,55,220,326,1591,0.44,0.491,0.301,0.686
1189,2019-20,Illinois–Chicago,35,18,17,0.514,834,2062,602,1263,232,799,507,757,382,861,1243,471,237,97,436,581,2407,0.404,0.477,0.29,0.67
1190,2023-24,Illinois State,32,15,17,0.469,790,1786,561,1084,229,702,356,484,273,791,1064,407,168,101,345,578,2165,0.442,0.518,0.326,0.736
1191,2022-23,Illinois State,32,11,21,0.344,805,1770,580,1103,225,667,420,601,278,714,992,395,214,99,357,552,2255,0.455,0.526,0.337,0.699
1192,2021-22,Illinois State,33,13,20,0.394,876,1987,621,1244,255,743,459,614,345,805,1150,439,240,83,408,540,2466,0.441,0.499,0.343,0.748
1193,2020-21,Illinois State,25,7,18,0.28,692,1546,494,905,198,641,288,398,238,661,899,398,175,62,299,368,1870,0.448,0.546,0.309,0.724
1194,2019-20,Illinois State,31,10,21,0.323,775,1744,544,1059,231,685,390,539,284,800,1084,413,206,83,417,477,2171,0.444,0.514,0.337,0.724
1195,2023-24,Illinois,38,29,9,0.763,1044,2418,811,1734,233,684,466,646,381,878,1259,460,218,122,331,707,2787,0.432,0.468,0.341,0.721
1196,2022-23,Illinois,33,20,13,0.606,804,1934,607,1345,197,589,411,583,322,793,1115,353,228,93,429,604,2216,0.416,0.451,0.334,0.705
1197,2021-22,Illinois,33,23,10,0.697,816,1977,629,1392,187,585,399,558,323,767,1090,337,218,96,351,596,2218,0.413,0.452,0.32,0.715
1198,2020-21,Illinois,31,24,7,0.774,770,1873,569,1262,201,611,387,563,257,685,942,347,208,119,358,608,2128,0.411,0.451,0.329,0.687
1199,2019-20,Illinois,31,21,10,0.677,758,1825,558,1223,200,602,308,426,285,706,991,351,179,100,359,577,2024,0.415,0.456,0.332,0.723
1200,2023-24,Idaho State,34,14,20,0.412,881,1835,682,1267,199,568,422,566,259,770,1029,411,213,80,415,605,2383,0.48,0.538,0.35,0.746
1201,2022-23,Idaho State,32,11,21,0.344,796,1764,603,1165,193,599,487,620,282,797,1079,378,178,70,387,577,2272,0.451,0.518,0.322,0.785
1202,2021-22,Idaho State,30,7,23,0.233,766,1636,566,1041,200,595,414,564,254,733,987,345,204,79,337,583,2146,0.468,0.544,0.336,0.734
1203,2020-21,Idaho State,24,13,11,0.542,524,1297,384,888,140,409,293,428,203,509,712,234,173,45,304,496,1481,0.404,0.432,0.342,0.685
1204,2019-20,Idaho State,30,8,22,0.267,850,1760,695,1279,155,481,343,454,259,702,961,352,180,96,340,560,2198,0.483,0.543,0.322,0.756
1205,2023-24,Idaho,32,11,21,0.344,789,1736,553,1067,236,669,464,636,284,801,1085,422,208,111,355,485,2278,0.454,0.518,0.353,0.73
1206,2022-23,Idaho,32,10,22,0.313,848,1805,626,1219,222,586,414,565,277,786,1063,365,186,95,368,603,2332,0.47,0.514,0.379,0.733
1207,2021-22,Idaho,31,9,22,0.29,906,1887,685,1254,221,633,435,627,279,824,1103,377,193,109,325,584,2468,0.48,0.546,0.349,0.694
1208,2020-21,Idaho,22,1,21,0.045,588,1244,414,787,174,457,332,445,213,540,753,286,196,67,257,369,1682,0.473,0.526,0.381,0.746
1209,2019-20,Idaho,32,8,24,0.25,859,1903,616,1164,243,739,368,535,289,807,1096,453,223,94,357,534,2329,0.451,0.529,0.329,0.688
1210,2023-24,Howard,35,18,17,0.514,913,2035,686,1367,227,668,547,786,373,752,1125,431,266,125,428,663,2600,0.449,0.502,0.34,0.696
1211,2022-23,Howard,35,22,13,0.629,902,2027,649,1284,253,743,485,706,383,785,1168,428,308,110,540,615,2542,0.445,0.505,0.341,0.687
1212,2021-22,Howard,29,16,13,0.552,718,1682,537,1134,181,548,402,572,342,725,1067,342,207,92,516,527,2019,0.427,0.474,0.33,0.703
1213,2020-21,Howard,5,1,4,0.2,156,333,107,196,49,137,63,101,60,138,198,98,41,15,44,97,424,0.468,0.546,0.358,0.624
1214,2019-20,Howard,33,4,29,0.121,963,2057,698,1297,265,760,491,719,442,890,1332,593,206,84,455,585,2682,0.468,0.538,0.349,0.683
1215,2023-24,Houston Christian,29,6,23,0.207,908,1915,688,1267,220,648,384,533,345,764,1109,471,266,139,300,519,2420,0.474,0.543,0.34,0.72
1216,2022-23,Houston Baptist,32,10,22,0.313,984,1978,742,1318,242,660,448,630,328,790,1118,508,252,97,405,627,2658,0.497,0.563,0.367,0.711
1217,2021-22,Houston Baptist,29,11,18,0.379,777,1664,553,1066,224,598,442,593,242,708,950,375,229,96,425,575,2220,0.467,0.519,0.375,0.745
1218,2020-21,Houston Baptist,25,6,19,0.24,740,1573,532,968,208,605,319,444,281,671,952,393,224,79,356,446,2007,0.47,0.55,0.344,0.718
1219,2019-20,Houston Baptist,29,4,25,0.138,981,1898,736,1260,245,638,516,697,328,742,1070,555,249,133,381,575,2723,0.517,0.584,0.384,0.74
1220,2023-24,Houston,37,32,5,0.865,706,1862,481,1115,225,747,495,734,398,853,1251,422,186,102,585,599,2132,0.379,0.431,0.301,0.674
1221,2022-23,Houston,37,33,4,0.892,708,1933,474,1093,234,840,476,691,370,803,1173,376,199,91,506,599,2126,0.366,0.434,0.279,0.689
1222,2021-22,Houston,38,32,6,0.842,744,2003,498,1148,246,855,499,696,379,837,1216,411,225,89,541,641,2233,0.371,0.434,0.288,0.717
1223,2020-21,Houston,32,28,4,0.875,621,1642,440,1017,181,625,440,665,307,703,1010,333,158,80,452,560,1863,0.378,0.433,0.29,0.662
1224,2019-20,Houston,31,23,8,0.742,632,1652,445,999,187,653,475,688,284,707,991,342,160,70,379,593,1926,0.383,0.445,0.286,0.69
1225,2023-24,Holy Cross,33,10,23,0.303,878,1922,588,1164,290,758,416,574,311,859,1170,464,217,104,278,467,2462,0.457,0.505,0.383,0.725
1226,2022-23,Holy Cross,32,10,22,0.313,876,1926,657,1254,219,672,353,527,345,889,1234,436,225,106,393,459,2324,0.455,0.524,0.326,0.67
1227,2021-22,Holy Cross,31,9,22,0.29,814,1753,612,1186,202,567,362,527,283,812,1095,416,188,105,381,502,2192,0.464,0.516,0.356,0.687
1228,2020-21,Holy Cross,16,5,11,0.313,436,934,326,625,110,309,235,329,171,416,587,212,111,53,210,254,1217,0.467,0.522,0.356,0.714
1229,2019-20,Holy Cross,32,3,29,0.094,939,1904,701,1265,238,639,421,601,300,837,1137,449,235,100,343,463,2537,0.493,0.554,0.372,0.7
1230,2023-24,Hofstra,33,20,13,0.606,786,1899,512,1103,274,796,413,543,343,821,1164,424,183,83,395,466,2259,0.414,0.464,0.344,0.761
1231,2022-23,Hofstra,35,25,10,0.714,862,2115,626,1346,236,769,364,524,412,866,1278,436,202,106,442,531,2324,0.408,0.465,0.307,0.695
1232,2021-22,Hofstra,32,21,11,0.656,851,1881,559,1091,292,790,339,461,293,849,1142,481,170,90,470,487,2333,0.452,0.512,0.37,0.735
1233,2020-21,Hofstra,23,13,10,0.565,618,1383,440,856,178,527,265,357,234,582,816,373,136,72,277,420,1679,0.447,0.514,0.338,0.742
1234,2019-20,Hofstra,34,26,8,0.765,898,2019,674,1284,224,735,306,424,341,808,1149,492,199,85,464,622,2326,0.445,0.525,0.305,0.722
1235,2023-24,High Point,36,27,9,0.75,944,2142,712,1466,232,676,560,771,338,796,1134,421,178,100,360,762,2680,0.441,0.486,0.343,0.726
1236,2022-23,High Point,31,14,17,0.452,856,1942,614,1193,242,749,438,654,384,790,1174,451,218,105,383,605,2392,0.441,0.515,0.323,0.67
1237,2021-22,High Point,32,14,18,0.438,803,1863,600,1175,203,688,423,639,346,816,1162,433,212,109,397,549,2232,0.431,0.511,0.295,0.662
1238,2020-21,High Point,24,9,15,0.375,582,1312,373,723,209,589,304,447,225,592,817,339,150,102,326,462,1677,0.444,0.516,0.355,0.68
1239,2019-20,High Point,32,9,23,0.281,822,1779,502,956,320,823,432,635,294,757,1051,498,222,114,395,608,2396,0.462,0.525,0.389,0.68
1240,2023-24,Hawaii,34,20,14,0.588,860,1935,706,1439,154,496,463,638,286,800,1086,317,212,82,371,621,2337,0.444,0.491,0.31,0.726
1241,2022-23,Hawaii,33,22,11,0.667,760,1877,615,1384,145,493,374,504,301,763,1064,254,198,103,355,601,2039,0.405,0.444,0.294,0.742
1242,2021-22,Hawaii,28,17,11,0.607,652,1559,504,1083,148,476,344,479,231,630,861,247,181,74,295,510,1796,0.418,0.465,0.311,0.718
1243,2020-21,Hawaii,21,11,10,0.524,541,1220,420,850,121,370,249,342,174,500,674,220,148,58,254,383,1452,0.443,0.494,0.327,0.728
1244,2019-20,Hawaii,30,17,13,0.567,739,1680,587,1231,152,449,386,534,259,747,1006,281,184,95,399,556,2016,0.44,0.477,0.339,0.723
1245,2023-24,Harvard,27,14,13,0.519,710,1667,479,983,231,684,286,413,313,683,996,375,183,101,298,453,1937,0.426,0.487,0.338,0.692
1246,2022-23,Harvard,28,14,14,0.5,680,1612,479,987,201,625,297,401,238,664,902,322,196,87,357,472,1858,0.422,0.485,0.322,0.741
1247,2021-22,Harvard,26,13,13,0.5,633,1434,423,868,210,566,321,440,198,714,912,323,164,78,392,444,1797,0.441,0.487,0.371,0.73
1248,2019-20,Harvard,29,21,8,0.724,685,1676,490,1086,195,590,363,524,269,698,967,302,203,72,374,541,1928,0.409,0.451,0.331,0.693
1249,2022-23,Hartford,28,5,23,0.179,734,1596,505,987,229,609,294,414,285,687,972,431,204,84,341,393,1991,0.46,0.512,0.376,0.71
1250,2021-22,Hartford,32,12,20,0.375,832,1858,578,1146,254,712,391,537,313,796,1109,396,211,93,355,464,2309,0.448,0.504,0.357,0.728
1251,2020-21,Hartford,24,15,9,0.625,574,1375,411,813,163,562,223,335,245,595,840,278,138,83,322,388,1534,0.417,0.506,0.29,0.666
1252,2019-20,Hartford,33,18,15,0.545,797,1946,591,1196,206,750,403,578,377,887,1264,422,220,101,440,562,2203,0.41,0.494,0.275,0.697
1253,2023-24,Hampton,33,9,24,0.273,901,2064,639,1244,262,820,456,606,371,862,1233,441,236,90,359,532,2520,0.437,0.514,0.32,0.752
1254,2022-23,Hampton,32,8,24,0.25,878,1889,616,1188,262,701,463,670,327,916,1243,483,179,113,357,589,2481,0.465,0.519,0.374,0.691
1255,2021-22,Hampton,28,9,19,0.321,692,1661,530,1099,162,562,400,604,331,777,1108,318,171,85,335,505,1946,0.417,0.482,0.288,0.662
1256,2020-21,Hampton,25,11,14,0.44,637,1487,447,925,190,562,367,527,301,692,993,318,161,68,314,379,1831,0.428,0.483,0.338,0.696
1257,2019-20,Hampton,34,15,19,0.441,934,2090,653,1285,281,805,544,784,387,885,1272,503,188,101,386,687,2693,0.447,0.508,0.349,0.694
1258,2023-24,Green Bay,32,18,14,0.563,782,1799,592,1163,190,636,453,620,305,740,1045,399,201,126,297,500,2207,0.435,0.509,0.299,0.731
1259,2022-23,Green Bay,32,3,29,0.094,893,1832,671,1198,222,634,439,578,321,848,1169,443,234,105,342,532,2447,0.487,0.56,0.35,0.76
1260,2021-22,Green Bay,30,5,25,0.167,748,1598,557,1045,191,553,381,497,245,715,960,356,211,90,353,508,2068,0.468,0.533,0.345,0.767
1261,2020-21,Green Bay,25,8,17,0.32,695,1468,513,965,182,503,341,468,241,658,899,312,142,67,294,406,1913,0.473,0.532,0.362,0.729
1262,2019-20,Green Bay,33,17,16,0.515,925,2101,636,1262,289,839,504,672,389,887,1276,477,189,85,479,607,2643,0.44,0.504,0.344,0.75
1263,2023-24,Grand Canyon,35,30,5,0.857,822,2039,600,1345,222,694,480,678,397,784,1181,396,214,94,487,708,2346,0.403,0.446,0.32,0.708
1264,2022-23,Grand Canyon,36,24,12,0.667,863,2112,643,1418,220,694,475,676,395,816,1211,374,201,96,387,642,2421,0.409,0.453,0.317,0.703
1265,2021-22,Grand Canyon,31,23,8,0.742,675,1752,510,1148,165,604,383,555,318,740,1058,291,180,94,403,545,1898,0.385,0.444,0.273,0.69
1266,2020-21,Grand Canyon,24,17,7,0.708,521,1360,353,790,168,570,281,397,198,530,728,241,136,51,279,430,1491,0.383,0.447,0.295,0.708
1267,2019-20,Grand Canyon,30,13,17,0.433,779,1765,525,1051,254,714,379,521,296,752,1048,429,163,74,334,547,2191,0.441,0.5,0.356,0.727
1268,2023-24,Grambling State,36,21,15,0.583,891,2042,649,1339,242,703,482,664,388,815,1203,495,254,105,461,586,2506,0.436,0.485,0.344,0.726
1269,2022-23,Grambling State,33,24,9,0.727,685,1801,476,1122,209,679,475,716,382,747,1129,354,231,104,484,605,2054,0.38,0.424,0.308,0.663
1270,2021-22,Grambling State,32,12,20,0.375,774,1839,541,1179,233,660,492,719,367,862,1229,401,227,144,445,527,2273,0.421,0.459,0.353,0.684
1271,2020-21,Grambling State,24,12,12,0.5,558,1399,377,866,181,533,352,529,271,608,879,348,184,109,359,440,1649,0.399,0.435,0.34,0.665
1272,2019-20,Grambling State,32,17,15,0.531,754,1834,521,1126,233,708,447,656,311,751,1062,442,213,94,477,603,2188,0.411,0.463,0.329,0.681
1273,2023-24,Gonzaga,35,27,8,0.771,882,2169,615,1374,267,795,389,541,371,739,1110,434,190,90,392,584,2420,0.407,0.448,0.336,0.719
1274,2022-23,Gonzaga,37,31,6,0.838,993,2246,687,1369,306,877,423,577,334,837,1171,458,193,89,489,700,2715,0.442,0.502,0.349,0.733
1275,2021-22,Gonzaga,32,28,4,0.875,789,2075,578,1384,211,691,330,472,315,753,1068,326,194,92,384,585,2119,0.38,0.418,0.305,0.699
1276,2020-21,Gonzaga,32,31,1,0.969,829,1966,612,1303,217,663,355,505,271,700,971,377,195,89,461,616,2230,0.422,0.47,0.327,0.703
1277,2019-20,Gonzaga,33,31,2,0.939,855,2028,634,1337,221,691,308,442,279,738,1017,371,200,97,443,638,2239,0.422,0.474,0.32,0.697
1278,2023-24,Georgia Tech,32,14,18,0.438,846,1976,592,1197,254,779,461,624,339,794,1133,431,221,103,283,520,2407,0.428,0.495,0.326,0.739
1279,2022-23,Georgia Tech,33,15,18,0.455,856,1943,650,1259,206,684,417,586,351,860,1211,481,181,118,362,500,2335,0.441,0.516,0.301,0.712
1280,2021-22,Georgia Tech,32,12,20,0.375,807,1851,581,1133,226,718,424,590,311,821,1132,477,212,104,422,467,2264,0.436,0.513,0.315,0.719
1281,2020-21,Georgia Tech,26,17,9,0.654,668,1455,479,942,189,513,296,420,251,639,890,368,141,73,408,394,1821,0.459,0.508,0.368,0.705
1282,2019-20,Georgia Tech,31,17,14,0.548,719,1800,551,1210,168,590,453,637,327,719,1046,372,240,112,428,560,2059,0.399,0.455,0.285,0.711
1283,2023-24,Georgia State,31,14,17,0.452,816,1914,596,1181,220,733,467,657,349,844,1193,404,174,126,326,495,2319,0.426,0.505,0.3,0.711
1284,2022-23,Georgia State,31,10,21,0.323,755,1734,540,1138,215,596,425,588,288,733,1021,394,210,114,372,532,2150,0.435,0.475,0.361,0.723
1285,2021-22,Georgia State,29,18,11,0.621,671,1609,454,1018,217,591,347,506,304,751,1055,377,181,101,471,487,1906,0.417,0.446,0.367,0.686
1286,2020-21,Georgia State,22,16,6,0.727,554,1342,369,795,185,547,306,439,265,549,814,268,138,63,324,384,1599,0.413,0.464,0.338,0.697
1287,2019-20,Georgia State,32,19,13,0.594,754,1869,566,1206,188,663,615,849,388,804,1192,381,202,118,508,568,2311,0.403,0.469,0.284,0.724
1288,2023-24,Georgia Southern,33,9,24,0.273,887,1947,636,1239,251,708,590,838,400,858,1258,439,246,136,401,512,2615,0.456,0.513,0.355,0.704
1289,2022-23,Georgia Southern,33,17,16,0.515,779,1838,556,1149,223,689,420,600,309,848,1157,379,203,87,429,526,2201,0.424,0.484,0.324,0.7
1290,2021-22,Georgia Southern,29,13,16,0.448,661,1613,456,986,205,627,376,545,302,705,1007,327,218,81,396,451,1903,0.41,0.462,0.327,0.69
1291,2020-21,Georgia Southern,26,13,13,0.5,622,1469,421,894,201,575,317,448,258,636,894,276,186,72,410,435,1762,0.423,0.471,0.35,0.708
1292,2019-20,Georgia Southern,33,20,13,0.606,861,1983,639,1251,222,732,388,546,349,897,1246,431,194,77,522,631,2332,0.434,0.511,0.303,0.711
1293,2023-24,Georgia,37,20,17,0.541,998,2289,716,1437,282,852,486,671,418,987,1405,541,238,158,423,667,2764,0.436,0.498,0.331,0.724
1294,2022-23,Georgia,32,16,16,0.5,841,1912,617,1210,224,702,383,553,351,787,1138,469,214,117,368,588,2289,0.44,0.51,0.319,0.693
1295,2021-22,Georgia,32,6,26,0.188,942,1988,657,1171,285,817,343,479,334,780,1114,529,250,160,351,569,2512,0.474,0.561,0.349,0.716
1296,2020-21,Georgia,26,14,12,0.538,736,1609,532,1008,204,601,351,499,300,643,943,355,224,115,431,500,2027,0.457,0.528,0.339,0.703
1297,2019-20,Georgia,32,16,16,0.5,897,1980,675,1293,222,687,402,608,354,789,1143,416,207,107,422,574,2418,0.453,0.522,0.323,0.661
1298,2023-24,Georgetown,32,9,23,0.281,901,1841,653,1138,248,703,442,618,310,777,1087,500,240,125,356,537,2492,0.489,0.574,0.353,0.715
1299,2022-23,Georgetown,32,7,25,0.219,918,2001,610,1210,308,791,356,489,346,850,1196,552,259,96,356,491,2500,0.459,0.504,0.389,0.728
1300,2021-22,Georgetown,31,6,25,0.194,862,1876,574,1096,288,780,376,518,324,827,1151,526,214,140,397,495,2388,0.459,0.524,0.369,0.726
1301,2020-21,Georgetown,26,13,13,0.5,679,1609,462,968,217,641,288,416,269,636,905,390,197,73,298,447,1863,0.422,0.477,0.339,0.692
1302,2019-20,Georgetown,32,15,17,0.469,843,1952,546,1135,297,817,381,519,339,783,1122,490,244,99,431,604,2364,0.432,0.481,0.364,0.734
1303,2023-24,George Washington,32,15,17,0.469,917,2128,635,1318,282,810,356,473,364,839,1203,451,218,114,323,515,2472,0.431,0.482,0.348,0.753
1304,2022-23,George Washington,32,16,16,0.5,892,1999,618,1215,274,784,397,568,353,773,1126,455,224,78,355,545,2455,0.446,0.509,0.349,0.699
1305,2021-22,George Washington,30,12,18,0.4,805,1818,612,1190,193,628,382,533,338,823,1161,405,201,123,381,436,2185,0.443,0.514,0.307,0.717
1306,2020-21,George Washington,17,5,12,0.294,463,1034,334,657,129,377,174,258,178,420,598,252,122,62,197,274,1229,0.448,0.508,0.342,0.674
1307,2019-20,George Washington,32,12,20,0.375,832,1845,647,1285,185,560,394,574,295,835,1130,377,224,117,339,544,2243,0.451,0.504,0.33,0.686
1308,2023-24,George Mason,32,20,12,0.625,723,1791,462,1039,261,752,402,559,314,695,1009,373,217,115,343,566,2109,0.404,0.445,0.347,0.719
1309,2022-23,George Mason,33,20,13,0.606,798,1872,600,1214,198,658,426,618,289,782,1071,362,229,96,380,635,2220,0.426,0.494,0.301,0.689
1310,2021-22,George Mason,30,14,16,0.467,720,1702,473,983,247,719,369,504,245,745,990,359,204,85,349,512,2056,0.423,0.481,0.344,0.732
1311,2020-21,George Mason,22,13,9,0.591,558,1275,396,819,162,456,260,359,186,588,774,247,144,57,310,370,1538,0.438,0.484,0.355,0.724
1312,2019-20,George Mason,32,17,15,0.531,791,1816,573,1124,218,692,368,555,313,767,1080,395,209,117,408,588,2168,0.436,0.51,0.315,0.663
1313,2023-24,Gardner-Webb,33,17,16,0.515,839,1934,617,1265,222,669,514,726,311,890,1201,390,196,117,378,580,2414,0.434,0.488,0.332,0.708
1314,2022-23,Gardner-Webb,31,15,16,0.484,678,1639,470,1021,208,618,468,654,252,733,985,328,198,87,438,544,2032,0.414,0.46,0.337,0.716
1315,2021-22,Gardner-Webb,31,18,13,0.581,673,1727,470,1009,203,718,440,600,248,806,1054,348,203,94,406,500,1989,0.39,0.466,0.283,0.733
1316,2020-21,Gardner-Webb,26,11,15,0.423,598,1434,399,851,199,583,383,523,256,657,913,334,142,82,317,429,1778,0.417,0.469,0.341,0.732
1317,2019-20,Gardner-Webb,32,16,16,0.5,797,1890,531,1091,266,799,412,579,325,806,1131,446,191,88,399,539,2272,0.422,0.487,0.333,0.712
1318,2023-24,Furman,33,17,16,0.515,940,2036,697,1327,243,709,383,562,315,868,1183,465,230,118,397,554,2506,0.462,0.525,0.343,0.681
1319,2022-23,Furman,36,28,8,0.778,937,2094,695,1361,242,733,447,630,338,866,1204,417,204,102,470,617,2563,0.447,0.511,0.33,0.71
1320,2021-22,Furman,34,22,12,0.647,878,1941,642,1230,236,711,344,471,312,823,1135,450,200,97,441,467,2336,0.452,0.522,0.332,0.73
1321,2020-21,Furman,25,16,9,0.64,635,1440,454,881,181,559,272,423,228,597,825,326,179,69,370,366,1723,0.441,0.515,0.324,0.643
1322,2019-20,Furman,32,25,7,0.781,784,1795,555,1053,229,742,326,455,301,804,1105,430,201,86,517,510,2123,0.437,0.527,0.309,0.716
1323,2023-24,Fresno State,33,12,21,0.364,901,1952,632,1230,269,722,368,537,344,810,1154,450,201,127,347,526,2439,0.462,0.514,0.373,0.685
1324,2022-23,Fresno State,31,11,20,0.355,711,1607,484,1004,227,603,387,512,266,746,1012,374,175,96,401,484,2036,0.442,0.482,0.376,0.756
1325,2021-22,Fresno State,36,23,13,0.639,764,1866,509,1079,255,787,356,508,263,831,1094,381,198,76,447,598,2139,0.409,0.472,0.324,0.701
1326,2020-21,Fresno State,24,12,12,0.5,567,1309,392,808,175,501,309,422,202,572,774,264,160,76,314,447,1618,0.433,0.485,0.349,0.732
1327,2019-20,Fresno State,30,11,19,0.367,720,1722,467,1015,253,707,375,499,277,748,1025,371,173,70,314,504,2068,0.418,0.46,0.358,0.752
1328,2023-24,Fordham,33,13,20,0.394,805,1795,606,1238,199,557,580,809,300,889,1189,404,225,127,459,608,2389,0.448,0.489,0.357,0.717
1329,2022-23,Fordham,33,25,8,0.758,774,1841,594,1279,180,562,503,687,291,836,1127,377,212,100,448,640,2231,0.42,0.464,0.32,0.732
1330,2021-22,Fordham,32,16,16,0.5,780,1833,582,1200,198,633,379,558,302,882,1184,384,185,103,438,551,2137,0.426,0.485,0.313,0.679
1331,2020-21,Fordham,14,2,12,0.143,332,763,210,398,122,365,146,212,140,399,539,217,95,37,173,209,932,0.435,0.528,0.334,0.689
1332,2019-20,Fordham,31,9,22,0.29,655,1635,422,865,233,770,370,542,279,871,1150,403,211,82,430,499,1913,0.401,0.488,0.303,0.683
1333,2023-24,Florida State,33,17,16,0.515,859,1892,603,1169,256,723,544,775,372,842,1214,416,186,98,493,616,2518,0.454,0.516,0.354,0.702
1334,2022-23,Florida State,32,9,23,0.281,854,1882,563,1109,291,773,440,582,334,794,1128,473,165,91,377,517,2439,0.454,0.508,0.376,0.756
1335,2021-22,Florida State,31,17,14,0.548,786,1769,510,1021,276,748,382,538,328,762,1090,433,182,95,448,495,2230,0.444,0.5,0.369,0.71
1336,2020-21,Florida State,25,18,7,0.72,582,1465,394,886,188,579,378,515,290,536,826,299,174,69,344,415,1730,0.397,0.445,0.325,0.734
1337,2019-20,Florida State,31,26,5,0.839,694,1708,476,1021,218,687,431,588,321,698,1019,309,165,89,516,530,2037,0.406,0.466,0.317,0.733
1338,2023-24,Florida International,33,11,22,0.333,891,1876,624,1200,267,676,476,681,392,889,1281,489,233,117,570,532,2525,0.475,0.52,0.395,0.699
1339,2022-23,Florida International,32,14,18,0.438,848,1907,570,1142,278,765,430,580,414,803,1217,452,264,108,528,499,2404,0.445,0.499,0.363,0.741
1340,2021-22,Florida International,32,15,17,0.469,806,1884,563,1153,243,731,419,587,343,828,1171,427,227,98,424,466,2274,0.428,0.488,0.332,0.714
1341,2020-21,Florida International,26,9,17,0.346,725,1535,550,1049,175,486,360,505,285,710,995,335,183,72,431,393,1985,0.472,0.524,0.36,0.713
1342,2019-20,Florida International,32,19,13,0.594,837,1981,633,1272,204,709,441,600,416,828,1244,409,248,94,522,520,2319,0.423,0.498,0.288,0.735
1343,2023-24,Florida Gulf Coast,32,14,18,0.438,819,1845,539,1053,280,792,358,512,307,736,1043,425,202,81,332,485,2276,0.444,0.512,0.354,0.699
1344,2022-23,Florida Gulf Coast,32,17,15,0.531,804,1848,549,1084,255,764,359,516,320,805,1125,409,183,92,377,497,2222,0.435,0.506,0.334,0.696
1345,2021-22,Florida Gulf Coast,34,22,12,0.647,941,2153,668,1334,273,819,350,518,349,841,1190,468,230,77,393,526,2505,0.437,0.501,0.333,0.676
1346,2020-21,Florida Gulf Coast,18,10,8,0.556,461,1095,333,686,128,409,192,279,191,484,675,213,128,63,260,284,1242,0.421,0.485,0.313,0.688
1347,2019-20,Florida Gulf Coast,32,10,22,0.313,761,1798,535,1130,226,668,374,542,323,807,1130,373,241,98,436,457,2122,0.423,0.473,0.338,0.69
1348,2023-24,Florida Atlantic,34,25,9,0.735,912,2096,657,1340,255,756,416,572,370,789,1159,356,204,84,394,611,2495,0.435,0.49,0.337,0.727
1349,2022-23,Florida Atlantic,39,35,4,0.897,923,2290,665,1490,258,800,443,603,364,922,1286,321,225,89,481,651,2547,0.403,0.446,0.323,0.735
1350,2021-22,Florida Atlantic,34,19,15,0.559,838,1889,606,1247,232,642,407,586,284,808,1092,371,204,101,468,546,2315,0.444,0.486,0.361,0.695
1351,2020-21,Florida Atlantic,23,13,10,0.565,533,1288,373,818,160,470,311,447,193,556,749,239,125,60,327,392,1537,0.414,0.456,0.34,0.696
1352,2019-20,Florida Atlantic,32,17,15,0.531,806,1832,570,1136,236,696,374,533,283,839,1122,376,209,73,485,526,2222,0.44,0.502,0.339,0.702
1353,2023-24,Florida A&M,29,6,23,0.207,777,1732,551,1106,226,626,460,685,331,728,1059,378,242,110,334,436,2240,0.449,0.498,0.361,0.672
1354,2022-23,Florida A&M,29,7,22,0.241,695,1572,515,1031,180,541,460,690,331,711,1042,349,239,108,363,482,2030,0.442,0.5,0.333,0.667
1355,2021-22,Florida A&M,30,13,17,0.433,713,1684,506,1087,207,597,431,643,358,759,1117,370,186,66,386,471,2064,0.423,0.466,0.347,0.67
1356,2020-21,Florida A&M,20,8,12,0.4,496,1161,376,740,120,421,258,393,233,475,708,239,147,53,304,347,1370,0.427,0.508,0.285,0.656
1357,2019-20,Florida A&M,27,12,15,0.444,699,1515,536,982,163,533,423,624,288,711,999,343,206,100,422,546,1984,0.461,0.546,0.306,0.678
1358,2023-24,Florida,36,24,12,0.667,1017,2311,773,1563,244,748,573,805,403,886,1289,431,269,145,389,698,2851,0.44,0.495,0.326,0.712
1359,2022-23,Florida,33,16,17,0.485,830,2002,638,1394,192,608,412,585,383,891,1274,370,217,102,412,542,2264,0.415,0.458,0.316,0.704
1360,2021-22,Florida,34,20,14,0.588,831,1884,631,1264,200,620,399,572,370,819,1189,408,258,90,497,600,2261,0.441,0.499,0.323,0.698
1361,2020-21,Florida,25,15,10,0.6,616,1458,454,930,162,528,363,512,276,555,831,316,189,83,357,444,1757,0.422,0.488,0.307,0.709
1362,2019-20,Florida,31,19,12,0.613,716,1699,519,1094,197,605,418,573,290,693,983,346,170,76,400,557,2047,0.421,0.474,0.326,0.729
1363,2023-24,FDU,32,15,17,0.469,885,1967,608,1187,277,780,435,626,361,914,1275,483,233,106,464,581,2482,0.45,0.512,0.355,0.695
1364,2022-23,Fairleigh Dickinson,37,21,16,0.568,972,2061,685,1241,287,820,513,690,344,913,1257,552,213,143,567,587,2744,0.472,0.552,0.35,0.743
1365,2021-22,Fairleigh Dickinson,26,4,22,0.154,746,1565,553,1015,193,550,373,534,307,700,1007,429,166,105,335,409,2058,0.477,0.545,0.351,0.699
1366,2020-21,Fairleigh Dickinson,24,9,15,0.375,680,1460,492,898,188,562,342,495,282,607,889,397,168,80,337,412,1890,0.466,0.548,0.335,0.691
1367,2019-20,Fairleigh Dickinson,30,11,19,0.367,801,1782,553,1058,248,724,386,551,335,744,1079,451,200,93,384,477,2236,0.449,0.523,0.343,0.701
1368,2023-24,Fairfield,37,24,13,0.649,987,2156,718,1364,269,792,383,549,375,924,1299,497,210,109,515,566,2626,0.458,0.526,0.34,0.698
1369,2022-23,Fairfield,31,13,18,0.419,769,1748,608,1195,161,553,346,483,306,754,1060,336,183,102,363,556,2045,0.44,0.509,0.291,0.716
1370,2021-22,Fairfield,33,15,18,0.455,797,1866,613,1300,184,566,399,571,318,813,1131,337,176,114,373,539,2177,0.427,0.472,0.325,0.699
1371,2020-21,Fairfield,27,10,17,0.37,663,1517,498,1011,165,506,309,466,248,678,926,330,165,94,290,508,1800,0.437,0.493,0.326,0.663
1372,2019-20,Fairfield,32,12,20,0.375,709,1692,491,1070,218,622,376,526,273,757,1030,365,195,98,399,583,2012,0.419,0.459,0.35,0.715
1373,2023-24,Evansville,35,17,18,0.486,912,2074,597,1175,315,899,423,574,318,928,1246,496,226,103,425,557,2562,0.44,0.508,0.35,0.737
1374,2022-23,Evansville,32,5,27,0.156,867,1809,584,1064,283,745,415,544,258,964,1222,502,186,85,421,526,2432,0.479,0.549,0.38,0.763
1375,2021-22,Evansville,30,6,24,0.2,784,1580,580,1045,204,535,350,477,181,864,1045,359,160,71,349,447,2122,0.496,0.555,0.381,0.734
1376,2020-21,Evansville,25,9,16,0.36,645,1255,495,889,150,366,300,431,165,635,800,280,129,56,289,399,1740,0.514,0.557,0.41,0.696
1377,2019-20,Evansville,32,9,23,0.281,865,1834,673,1293,192,541,446,597,270,882,1152,358,177,80,377,591,2368,0.472,0.52,0.355,0.747
1378,2023-24,Elon,32,13,19,0.406,880,1925,614,1142,266,783,387,542,360,766,1126,482,195,101,355,520,2413,0.457,0.538,0.34,0.714
1379,2022-23,Elon,32,8,24,0.25,815,1869,524,1026,291,843,370,521,339,813,1152,466,198,96,368,514,2291,0.436,0.511,0.345,0.71
1380,2021-22,Elon,32,10,22,0.313,760,1754,527,1082,233,672,558,745,309,817,1126,367,237,100,352,551,2311,0.433,0.487,0.347,0.749
1381,2020-21,Elon,19,10,9,0.526,421,985,292,580,129,405,264,402,136,499,635,185,119,62,235,301,1235,0.427,0.503,0.319,0.657
1382,2019-20,Elon,34,13,21,0.382,804,1820,532,1067,272,753,558,747,273,917,1190,424,201,100,403,589,2438,0.442,0.499,0.361,0.747
1383,2023-24,Eastern Washington,32,21,11,0.656,836,1912,555,1131,281,781,454,612,304,705,1009,435,217,79,384,622,2407,0.437,0.491,0.36,0.742
1384,2022-23,Eastern Washington,34,23,11,0.676,849,2005,555,1123,294,882,437,584,315,740,1055,420,219,64,383,596,2429,0.423,0.494,0.333,0.748
1385,2021-22,Eastern Washington,34,18,16,0.529,887,2071,603,1204,284,867,478,634,314,850,1164,425,209,92,391,645,2536,0.428,0.501,0.328,0.754
1386,2020-21,Eastern Washington,24,16,8,0.667,617,1479,451,950,166,529,290,401,229,597,826,278,138,53,279,438,1690,0.417,0.475,0.314,0.723
1387,2019-20,Eastern Washington,31,23,8,0.742,811,1898,602,1284,209,614,428,605,311,833,1144,446,223,99,446,582,2259,0.427,0.469,0.34,0.707
1388,2023-24,Eastern Michigan,31,13,18,0.419,820,1819,595,1107,225,712,387,561,333,796,1129,414,209,98,331,462,2252,0.451,0.537,0.316,0.69
1389,2022-23,Eastern Michigan,31,8,23,0.258,894,1846,632,1079,262,767,455,647,339,811,1150,418,196,86,384,513,2505,0.484,0.586,0.342,0.703
1390,2021-22,Eastern Michigan,31,10,21,0.323,859,1913,614,1223,245,690,393,560,322,863,1185,393,211,114,385,534,2356,0.449,0.502,0.355,0.702
1391,2020-21,Eastern Michigan,18,6,12,0.333,506,1057,337,602,169,455,181,268,176,503,679,320,108,41,278,297,1362,0.479,0.56,0.371,0.675
1392,2019-20,Eastern Michigan,32,16,16,0.5,710,1728,429,909,281,819,349,509,337,811,1148,455,204,82,537,601,2050,0.411,0.472,0.343,0.686
1393,2023-24,Eastern Kentucky,31,17,14,0.548,847,1984,594,1307,253,677,424,572,371,764,1135,411,222,80,350,518,2371,0.427,0.454,0.374,0.741
1394,2022-23,Eastern Kentucky,37,23,14,0.622,987,2291,678,1382,309,909,437,589,399,973,1372,531,241,105,536,561,2720,0.431,0.491,0.34,0.742
1395,2021-22,Eastern Kentucky,31,13,18,0.419,857,1843,611,1122,246,721,367,514,326,915,1241,478,193,100,541,458,2327,0.465,0.545,0.341,0.714
1396,2020-21,Eastern Kentucky,29,22,7,0.759,770,1735,569,1116,201,619,396,546,305,839,1144,442,179,81,555,479,2137,0.444,0.51,0.325,0.725
1397,2019-20,Eastern Kentucky,33,16,17,0.485,881,1951,663,1264,218,687,508,694,383,966,1349,481,230,109,603,576,2488,0.452,0.525,0.317,0.732
1398,2023-24,Eastern Illinois,32,14,18,0.438,757,1721,533,1084,224,637,434,605,279,856,1135,424,169,138,454,464,2172,0.44,0.492,0.352,0.717
1399,2022-23,Eastern Illinois,31,9,22,0.29,786,1806,527,1036,259,770,404,579,348,827,1175,466,202,109,457,549,2235,0.435,0.509,0.336,0.698
1400,2021-22,Eastern Illinois,31,5,26,0.161,820,1803,552,1016,268,787,297,435,346,794,1140,500,267,129,387,520,2205,0.455,0.543,0.341,0.683
1401,2020-21,Eastern Illinois,27,9,18,0.333,722,1601,505,1004,217,597,362,497,276,709,985,400,200,80,361,408,2023,0.451,0.503,0.363,0.728
1402,2019-20,Eastern Illinois,32,17,15,0.531,777,1835,564,1228,213,607,447,610,321,828,1149,395,192,93,490,551,2214,0.423,0.459,0.351,0.733
1403,2023-24,East Tennessee State,35,19,16,0.543,849,1961,604,1212,245,749,492,713,356,898,1254,402,238,115,468,594,2435,0.433,0.498,0.327,0.69
1404,2022-23,East Tennessee State,32,12,20,0.375,799,1834,545,1049,254,785,356,486,319,747,1066,404,228,73,389,516,2208,0.436,0.52,0.324,0.733
1405,2021-22,East Tennessee State,32,15,17,0.469,847,1888,551,1018,296,870,346,483,343,770,1113,465,193,81,362,471,2336,0.449,0.541,0.34,0.716
1406,2020-21,East Tennessee State,25,13,12,0.52,573,1370,362,753,211,617,297,429,223,600,823,321,161,77,344,421,1654,0.418,0.481,0.342,0.692
1407,2019-20,East Tennessee State,34,30,4,0.882,765,1801,557,1109,208,692,408,582,291,762,1053,352,203,100,533,660,2146,0.425,0.502,0.301,0.701
1408,2023-24,East Carolina,33,15,18,0.455,810,1835,552,1047,258,788,441,587,339,802,1141,431,201,113,415,545,2319,0.441,0.527,0.327,0.751
1409,2022-23,East Carolina,33,16,17,0.485,830,1905,614,1248,216,657,451,631,333,820,1153,414,216,116,392,584,2327,0.436,0.492,0.329,0.715
1410,2021-22,East Carolina,30,15,15,0.5,751,1736,500,1024,251,712,375,538,299,788,1087,458,208,125,385,528,2128,0.433,0.488,0.353,0.697
1411,2020-21,East Carolina,19,8,11,0.421,437,1032,296,593,141,439,276,388,174,507,681,245,126,61,277,330,1291,0.423,0.499,0.321,0.711
1412,2019-20,East Carolina,31,11,20,0.355,755,1762,501,1009,254,753,474,708,289,791,1080,427,216,98,413,587,2238,0.428,0.497,0.337,0.669
1413,2023-24,Duquesne,37,25,12,0.676,862,2037,618,1269,244,768,499,704,383,885,1268,459,235,140,485,624,2467,0.423,0.487,0.318,0.709
1414,2022-23,Duquesne,33,20,13,0.606,836,1875,613,1241,223,634,457,659,380,816,1196,440,195,100,475,538,2352,0.446,0.494,0.352,0.693
1415,2021-22,Duquesne,30,6,24,0.2,849,1783,622,1213,227,570,277,391,312,824,1136,453,179,122,387,425,2202,0.476,0.513,0.398,0.708
1416,2020-21,Duquesne,18,9,9,0.5,422,1011,310,616,112,395,252,359,193,456,649,240,122,56,241,298,1208,0.417,0.503,0.284,0.702
1417,2019-20,Duquesne,30,21,9,0.7,734,1728,542,1091,192,637,333,505,319,727,1046,389,189,90,414,531,1993,0.425,0.497,0.301,0.659
1418,2023-24,Duke,36,27,9,0.75,884,2055,657,1342,227,713,392,578,327,809,1136,450,192,159,407,579,2387,0.43,0.49,0.318,0.678
1419,2022-23,Duke,36,27,9,0.75,844,2079,618,1338,226,741,376,493,337,771,1108,409,220,132,391,588,2290,0.406,0.462,0.305,0.763
1420,2021-22,Duke,39,32,7,0.821,1027,2462,762,1635,265,827,324,469,436,887,1323,518,235,125,419,612,2643,0.417,0.466,0.32,0.691
1421,2020-21,Duke,24,13,11,0.542,623,1367,466,926,157,441,308,436,236,572,808,304,153,93,332,362,1711,0.456,0.503,0.356,0.706
1422,2019-20,Duke,31,25,6,0.806,784,1879,634,1378,150,501,389,580,330,737,1067,367,225,121,464,588,2107,0.417,0.46,0.299,0.671
1423,2023-24,Drexel,32,20,12,0.625,784,1874,575,1212,209,662,353,500,280,719,999,344,175,98,289,515,2130,0.418,0.474,0.316,0.706
1424,2022-23,Drexel,32,17,15,0.531,762,1793,592,1283,170,510,303,430,290,761,1051,360,186,85,384,540,1997,0.425,0.461,0.333,0.705
1425,2021-22,Drexel,29,15,14,0.517,771,1714,586,1164,185,550,311,444,257,729,986,317,185,72,319,473,2038,0.45,0.503,0.336,0.7
1426,2020-21,Drexel,20,12,8,0.6,504,1124,385,753,119,371,221,297,158,438,596,214,123,63,210,306,1348,0.448,0.511,0.321,0.744
1427,2019-20,Drexel,33,14,19,0.424,860,1911,679,1333,181,578,422,557,296,787,1083,388,253,108,368,569,2323,0.45,0.509,0.313,0.758
1428,2023-24,Drake,35,28,7,0.8,885,2000,628,1225,257,775,436,618,275,872,1147,370,192,93,431,601,2463,0.443,0.513,0.332,0.706
1429,2022-23,Drake,35,27,8,0.771,811,2001,578,1241,233,760,381,541,278,868,1146,354,185,80,421,586,2236,0.405,0.466,0.307,0.704
1430,2021-22,Drake,36,25,11,0.694,840,1956,596,1215,244,741,467,641,297,850,1147,362,199,106,477,588,2391,0.429,0.491,0.329,0.729
1431,2020-21,Drake,31,26,5,0.839,725,1718,532,1100,193,618,356,495,266,701,967,336,170,97,392,437,1999,0.422,0.484,0.312,0.719
1432,2019-20,Drake,34,20,14,0.588,803,1901,522,1136,281,765,415,561,257,830,1087,389,224,90,416,552,2302,0.422,0.46,0.367,0.74
1433,2021-22,Dixie State,31,13,18,0.419,837,1932,603,1192,234,740,388,560,327,845,1172,450,255,127,426,618,2296,0.433,0.506,0.316,0.693
1434,2020-21,Dixie State,21,8,13,0.381,581,1285,438,818,143,467,298,449,246,590,836,309,155,75,307,407,1603,0.452,0.535,0.306,0.664
1435,2023-24,Detroit Mercy,32,1,31,0.031,921,1878,662,1179,259,699,467,599,361,811,1172,482,197,98,380,515,2568,0.49,0.561,0.371,0.78
1436,2022-23,Detroit Mercy,33,14,19,0.424,893,1931,616,1174,277,757,423,560,325,772,1097,466,214,91,386,566,2486,0.462,0.525,0.366,0.755
1437,2021-22,Detroit Mercy,30,14,16,0.467,766,1643,531,972,235,671,348,491,279,718,997,439,181,59,378,469,2115,0.466,0.546,0.35,0.709
1438,2020-21,Detroit Mercy,22,12,10,0.545,607,1311,402,754,205,557,208,294,212,534,746,377,120,59,279,353,1627,0.463,0.533,0.368,0.707
1439,2019-20,Detroit Mercy,31,8,23,0.258,862,1876,595,1140,267,736,431,596,332,810,1142,536,197,108,374,557,2422,0.459,0.522,0.363,0.723
1440,2023-24,DePaul,32,3,29,0.094,949,1948,644,1147,305,801,413,554,343,826,1169,552,246,114,318,539,2616,0.487,0.561,0.381,0.745
1441,2022-23,DePaul,33,10,23,0.303,903,1984,662,1295,241,689,504,709,396,877,1273,469,239,110,415,546,2551,0.455,0.511,0.35,0.711
1442,2021-22,DePaul,31,15,16,0.484,819,1912,592,1238,227,674,373,498,330,791,1121,395,197,108,367,556,2238,0.428,0.478,0.337,0.749
1443,2020-21,DePaul,19,5,14,0.263,470,1127,329,670,141,457,286,398,225,490,715,262,139,75,274,306,1367,0.417,0.491,0.309,0.719
1444,2019-20,DePaul,32,16,16,0.5,766,1848,506,1075,260,773,482,651,348,831,1179,444,256,116,512,577,2274,0.415,0.471,0.336,0.74
1445,2023-24,Denver,34,17,17,0.5,993,2133,728,1384,265,749,486,657,348,904,1252,439,170,132,362,633,2737,0.466,0.526,0.354,0.74
1446,2022-23,Denver,32,15,17,0.469,871,1950,608,1165,263,785,397,526,313,682,995,448,216,117,359,621,2402,0.447,0.522,0.335,0.755
1447,2021-22,Denver,32,11,21,0.344,838,1871,573,1125,265,746,439,595,303,796,1099,387,171,105,373,568,2380,0.448,0.509,0.355,0.738
1448,2020-21,Denver,21,2,19,0.095,560,1174,387,721,173,453,369,479,171,551,722,237,136,70,286,418,1662,0.477,0.537,0.382,0.77
1449,2019-20,Denver,31,7,24,0.226,799,1787,549,1011,250,776,512,677,269,843,1112,388,193,80,395,590,2360,0.447,0.543,0.322,0.756
1450,2023-24,Delaware State,34,15,19,0.441,831,1914,554,1150,277,764,476,662,338,760,1098,440,248,95,531,634,2415,0.434,0.482,0.363,0.719
1451,2022-23,Delaware State,30,6,24,0.2,772,1660,489,958,283,702,438,633,281,757,1038,477,235,105,425,519,2265,0.465,0.51,0.403,0.692
1452,2021-22,Delaware State,28,2,26,0.071,700,1678,429,909,271,769,387,550,351,735,1086,448,223,95,398,502,2058,0.417,0.472,0.352,0.704
1453,2020-21,Delaware State,19,3,16,0.158,554,1183,393,731,161,452,360,509,223,558,781,300,161,77,280,349,1629,0.468,0.538,0.356,0.707
1454,2019-20,Delaware State,32,6,26,0.188,898,1925,626,1144,272,781,587,825,341,933,1274,501,254,107,472,588,2655,0.466,0.547,0.348,0.712
1455,2023-24,Delaware,33,19,14,0.576,848,1991,624,1268,224,723,379,536,338,798,1136,390,210,125,334,513,2299,0.426,0.492,0.31,0.707
1456,2022-23,Delaware,33,17,16,0.515,850,1888,612,1235,238,653,395,547,329,846,1175,454,203,109,421,585,2333,0.45,0.496,0.364,0.722
1457,2021-22,Delaware,35,22,13,0.629,879,2045,621,1315,258,730,440,579,365,809,1174,401,225,94,443,613,2456,0.43,0.472,0.353,0.76
1458,2020-21,Delaware,15,7,8,0.467,361,856,260,562,101,294,189,263,138,356,494,160,97,39,172,269,1012,0.422,0.463,0.344,0.719
1459,2019-20,Delaware,33,22,11,0.667,822,1924,560,1177,262,747,426,564,311,778,1089,412,220,81,386,542,2332,0.427,0.476,0.351,0.755
1460,2023-24,Dayton,33,25,8,0.758,816,1948,566,1166,250,782,311,427,338,743,1081,417,195,100,342,547,2193,0.419,0.485,0.32,0.728
1461,2022-23,Dayton,34,22,12,0.647,764,1942,544,1190,220,752,327,464,336,721,1057,371,197,77,352,591,2075,0.393,0.457,0.293,0.705
1462,2021-22,Dayton,35,24,11,0.686,790,1934,557,1215,233,719,330,458,280,748,1028,421,214,130,387,564,2143,0.408,0.458,0.324,0.721
1463,2020-21,Dayton,24,14,10,0.583,607,1432,433,890,174,542,239,377,258,538,796,306,135,70,285,405,1627,0.424,0.487,0.321,0.634
1464,2019-20,Dayton,31,29,2,0.935,727,1769,533,1181,194,588,352,547,305,676,981,343,167,83,400,556,2000,0.411,0.451,0.33,0.644
1465,2023-24,Davidson,32,15,17,0.469,761,1798,509,1042,252,756,400,580,309,819,1128,405,200,105,375,554,2174,0.423,0.488,0.333,0.69
1466,2022-23,Davidson,32,16,16,0.5,817,1843,596,1165,221,678,342,487,305,804,1109,399,190,122,371,579,2197,0.443,0.512,0.326,0.702
1467,2021-22,Davidson,34,27,7,0.794,792,1890,517,1067,275,823,385,521,256,803,1059,404,171,79,376,601,2244,0.419,0.485,0.334,0.739
1468,2020-21,Davidson,22,13,9,0.591,502,1176,340,695,162,481,245,337,157,502,659,238,104,49,230,352,1411,0.427,0.489,0.337,0.727
1469,2019-20,Davidson,30,16,14,0.533,718,1660,514,1045,204,615,385,542,248,728,976,361,154,85,345,510,2025,0.433,0.492,0.332,0.71
1470,2023-24,Dartmouth,27,6,21,0.222,719,1584,474,911,245,673,257,364,220,718,938,381,208,76,252,431,1940,0.454,0.52,0.364,0.706
1471,2022-23,Dartmouth,28,10,18,0.357,736,1669,544,1089,192,580,363,499,253,740,993,324,236,86,346,481,2027,0.441,0.5,0.331,0.727
1472,2021-22,Dartmouth,25,9,16,0.36,621,1395,436,871,185,524,278,391,220,668,888,266,150,56,328,395,1705,0.445,0.501,0.353,0.711
1473,2019-20,Dartmouth,29,12,17,0.414,675,1621,449,921,226,700,296,465,216,749,965,338,173,72,323,449,1872,0.416,0.488,0.323,0.637
1474,2023-24,Creighton,35,25,10,0.714,972,2324,763,1676,209,648,293,372,345,831,1176,401,210,99,266,517,2446,0.418,0.455,0.323,0.788
1475,2022-23,Creighton,37,24,13,0.649,983,2332,752,1644,231,688,334,460,326,904,1230,439,217,103,358,590,2531,0.422,0.457,0.336,0.726
1476,2021-22,Creighton,35,23,12,0.657,878,2215,645,1479,233,736,335,460,400,849,1249,397,237,122,374,547,2324,0.396,0.436,0.317,0.728
1477,2020-21,Creighton,31,22,9,0.71,771,1889,536,1148,235,741,338,482,330,807,1137,406,172,87,389,497,2115,0.408,0.467,0.317,0.701
1478,2019-20,Creighton,31,24,7,0.774,810,1928,578,1190,232,738,310,444,350,797,1147,413,150,100,383,511,2162,0.42,0.486,0.314,0.698
1479,2023-24,Cornell,30,22,8,0.733,806,1828,553,1068,253,760,376,585,347,722,1069,430,201,89,402,475,2241,0.441,0.518,0.333,0.643
1480,2022-23,Cornell,28,17,11,0.607,774,1643,543,993,231,650,350,491,270,694,964,456,182,87,446,487,2129,0.471,0.547,0.355,0.713
1481,2021-22,Cornell,26,15,11,0.577,696,1617,471,916,225,701,324,477,272,663,935,342,178,78,357,472,1941,0.43,0.514,0.321,0.679
1482,2019-20,Cornell,27,7,20,0.259,682,1521,472,922,210,599,338,473,262,685,947,373,153,95,340,411,1912,0.448,0.512,0.351,0.715
1483,2023-24,Coppin State,29,2,27,0.069,723,1613,514,1007,209,606,457,618,371,764,1135,424,259,98,431,455,2112,0.448,0.51,0.345,0.739
1484,2022-23,Coppin State,32,9,23,0.281,937,2029,652,1190,285,839,502,694,425,900,1325,548,241,99,440,566,2661,0.462,0.548,0.34,0.723
1485,2021-22,Coppin State,32,9,23,0.281,846,2017,551,1179,295,838,403,567,397,995,1392,454,219,91,505,548,2390,0.419,0.467,0.352,0.711
1486,2020-21,Coppin State,22,9,13,0.409,627,1506,438,892,189,614,298,407,304,723,1027,306,159,62,357,451,1741,0.416,0.491,0.308,0.732
1487,2019-20,Coppin State,31,11,20,0.355,815,1952,550,1158,265,794,403,590,359,950,1309,473,210,85,458,525,2298,0.418,0.475,0.334,0.683
1488,2023-24,Connecticut,40,37,3,0.925,894,2278,660,1529,234,749,514,709,395,809,1204,400,214,118,422,663,2536,0.392,0.432,0.312,0.725
1489,2022-23,Connecticut,39,31,8,0.795,856,2145,662,1492,194,653,595,810,361,812,1173,357,258,105,493,662,2501,0.399,0.444,0.297,0.735
1490,2021-22,Connecticut,33,23,10,0.697,762,1893,544,1276,218,617,413,601,334,751,1085,339,208,108,404,561,2155,0.403,0.426,0.353,0.687
1491,2020-21,Connecticut,23,15,8,0.652,514,1243,380,829,134,414,323,457,233,529,762,242,125,63,299,392,1485,0.414,0.458,0.324,0.707
1492,2019-20,Connecticut,31,19,12,0.613,728,1756,555,1232,173,524,449,608,326,760,1086,364,215,121,483,596,2078,0.415,0.45,0.33,0.738
1493,2023-24,Columbia,27,13,14,0.481,709,1616,483,921,226,695,312,434,269,633,902,404,170,108,336,419,1956,0.439,0.524,0.325,0.719
1494,2022-23,Columbia,29,7,22,0.241,819,1792,609,1158,210,634,349,499,344,801,1145,447,193,124,379,443,2197,0.457,0.526,0.331,0.699
1495,2021-22,Columbia,26,4,22,0.154,747,1608,489,922,258,686,297,401,253,703,956,387,219,83,310,395,2049,0.465,0.53,0.376,0.741
1496,2019-20,Columbia,30,6,24,0.2,820,1818,584,1107,236,711,305,452,268,890,1158,402,169,119,343,445,2181,0.451,0.528,0.332,0.675
1497,2023-24,Colorado State,36,25,11,0.694,865,2030,645,1346,220,684,472,637,333,847,1180,407,195,100,415,604,2422,0.426,0.479,0.322,0.741
1498,2022-23,Colorado State,33,15,18,0.455,827,1859,532,1050,295,809,406,550,302,791,1093,423,188,107,400,546,2355,0.445,0.507,0.365,0.738
1499,2021-22,Colorado State,31,25,6,0.806,743,1728,496,974,247,754,314,441,256,735,991,371,171,90,385,533,2047,0.43,0.509,0.328,0.712
1500,2020-21,Colorado State,28,20,8,0.714,688,1631,467,921,221,710,274,429,275,667,942,373,178,91,387,513,1871,0.422,0.507,0.311,0.639
1501,2019-20,Colorado State,32,20,12,0.625,848,1915,569,1100,279,815,332,458,268,787,1055,432,201,81,404,613,2307,0.443,0.517,0.342,0.725
1502,2023-24,Colorado,37,26,11,0.703,984,2234,732,1447,252,787,434,610,330,787,1117,430,272,136,392,657,2654,0.44,0.506,0.32,0.711
1503,2022-23,Colorado,35,18,17,0.514,842,1982,625,1306,217,676,447,623,305,870,1175,393,249,140,470,602,2348,0.425,0.479,0.321,0.717
1504,2021-22,Colorado,33,21,12,0.636,807,1921,573,1213,234,708,376,519,289,768,1057,368,230,119,398,616,2224,0.42,0.472,0.331,0.724
1505,2020-21,Colorado,32,23,9,0.719,734,1745,530,1133,204,612,370,507,270,709,979,358,152,93,420,529,2042,0.421,0.468,0.333,0.73
1506,2019-20,Colorado,32,21,11,0.656,758,1830,557,1242,201,588,340,478,266,744,1010,352,234,94,422,598,2057,0.414,0.448,0.342,0.711
1507,2023-24,College of Charleston,35,27,8,0.771,939,2112,670,1328,269,784,428,608,327,903,1230,407,214,115,403,577,2575,0.445,0.505,0.343,0.704
1508,2022-23,College of Charleston,35,31,4,0.886,899,2085,694,1414,205,671,350,517,319,870,1189,411,197,129,482,640,2353,0.431,0.491,0.306,0.677
1509,2021-22,College of Charleston,32,17,15,0.531,853,1886,626,1221,227,665,513,710,284,787,1071,402,257,162,458,580,2446,0.452,0.513,0.341,0.723
1510,2020-21,College of Charleston,19,9,10,0.474,465,1045,315,629,150,416,249,344,162,476,638,241,91,57,222,308,1329,0.445,0.501,0.361,0.724
1511,2019-20,College of Charleston,31,17,14,0.548,741,1745,525,1085,216,660,411,554,316,800,1116,377,155,99,373,531,2109,0.425,0.484,0.327,0.742
1512,2023-24,Colgate,35,25,10,0.714,834,2020,585,1208,249,812,325,485,312,844,1156,444,198,86,393,502,2242,0.413,0.484,0.307,0.67
1513,2022-23,Colgate,35,26,9,0.743,937,2056,667,1303,270,753,282,410,287,816,1103,511,209,109,432,514,2426,0.456,0.512,0.359,0.688
1514,2021-22,Colgate,35,23,12,0.657,883,2077,639,1348,244,729,339,501,320,854,1174,472,223,101,381,521,2349,0.425,0.474,0.335,0.677
1515,2020-21,Colgate,16,14,2,0.875,417,1016,320,648,97,368,183,267,163,398,561,178,88,47,191,282,1114,0.41,0.494,0.264,0.685
1516,2019-20,Colgate,34,25,9,0.735,876,2018,634,1238,242,780,321,490,320,879,1199,437,181,97,413,543,2315,0.434,0.512,0.31,0.655
1517,2023-24,Coastal Carolina,31,9,22,0.29,856,2035,548,1100,308,935,414,602,382,790,1172,478,263,108,293,511,2434,0.421,0.498,0.329,0.688
1518,2022-23,Coastal Carolina,31,11,20,0.355,808,1893,503,1034,305,859,373,520,343,755,1098,447,206,100,358,498,2294,0.427,0.486,0.355,0.717
1519,2021-22,Coastal Carolina,33,19,14,0.576,772,1984,499,1079,273,905,339,479,360,766,1126,424,235,92,403,517,2156,0.389,0.462,0.302,0.708
1520,2020-21,Coastal Carolina,26,18,8,0.692,619,1588,396,868,223,720,312,457,271,602,873,329,204,63,363,474,1773,0.39,0.456,0.31,0.683
1521,2019-20,Coastal Carolina,33,16,17,0.485,807,1910,518,1061,289,849,615,850,342,785,1127,457,244,101,457,620,2518,0.423,0.488,0.34,0.724
1522,2023-24,Cleveland State,36,21,15,0.583,929,2047,695,1263,234,784,530,751,424,897,1321,469,195,111,497,600,2622,0.454,0.55,0.298,0.706
1523,2022-23,Cleveland State,35,21,14,0.6,857,2022,613,1258,244,764,447,611,435,811,1246,427,216,136,488,565,2405,0.424,0.487,0.319,0.732
1524,2021-22,Cleveland State,31,20,11,0.645,742,1762,500,1003,242,759,442,587,336,676,1012,403,234,111,476,522,2168,0.421,0.499,0.319,0.753
1525,2020-21,Cleveland State,27,19,8,0.704,651,1532,452,883,199,649,421,576,309,647,956,342,173,78,373,449,1922,0.425,0.512,0.307,0.731
1526,2019-20,Cleveland State,32,11,21,0.344,774,1800,543,1115,231,685,519,720,371,785,1156,425,225,151,457,621,2298,0.43,0.487,0.337,0.721
1527,2023-24,Clemson,36,24,12,0.667,885,2140,594,1261,291,879,502,686,355,871,1226,396,218,90,341,573,2563,0.414,0.471,0.331,0.732
1528,2022-23,Clemson,34,23,11,0.676,798,1970,531,1166,267,804,445,604,303,825,1128,395,191,87,383,576,2308,0.405,0.455,0.332,0.737
1529,2021-22,Clemson,33,17,16,0.515,791,1858,527,1066,264,792,413,541,274,808,1082,400,178,123,375,530,2259,0.426,0.494,0.333,0.763
1530,2020-21,Clemson,24,16,8,0.667,529,1265,356,747,173,518,255,366,212,575,787,269,157,74,338,366,1486,0.418,0.477,0.334,0.697
1531,2019-20,Clemson,31,16,15,0.516,698,1697,454,948,244,749,348,487,259,817,1076,360,204,76,418,500,1988,0.411,0.479,0.326,0.715
1532,2023-24,Cincinnati,37,22,15,0.595,900,2148,649,1401,251,747,471,626,328,864,1192,480,247,133,445,580,2522,0.419,0.463,0.336,0.752
1533,2022-23,Cincinnati,36,23,13,0.639,915,2142,706,1473,209,669,456,616,348,901,1249,465,190,101,438,557,2495,0.427,0.479,0.312,0.74
1534,2021-22,Cincinnati,33,18,15,0.545,764,1897,582,1314,182,583,466,647,349,888,1237,400,189,112,411,542,2176,0.403,0.443,0.312,0.72
1535,2020-21,Cincinnati,23,12,11,0.522,568,1300,415,844,153,456,370,492,199,596,795,319,158,84,305,401,1659,0.437,0.492,0.336,0.752
1536,2019-20,Cincinnati,30,20,10,0.667,712,1788,503,1167,209,621,381,522,324,700,1024,361,201,117,421,574,2014,0.398,0.431,0.337,0.73
1537,2023-24,Chicago State,32,13,19,0.406,827,1789,627,1171,200,618,404,601,362,748,1110,410,224,93,462,546,2258,0.462,0.535,0.324,0.672
1538,2022-23,Chicago State,31,11,20,0.355,812,1783,578,1103,234,680,406,581,335,702,1037,451,208,111,357,500,2264,0.455,0.524,0.344,0.699
1539,2021-22,Chicago State,32,7,25,0.219,817,1766,563,1130,254,636,492,679,371,772,1143,463,211,110,406,564,2380,0.463,0.498,0.399,0.725
1540,2020-21,Chicago State,9,0,9,0.0,295,558,214,353,81,205,127,183,110,272,382,174,58,26,104,132,798,0.529,0.606,0.395,0.694
1541,2019-20,Chicago State,29,4,25,0.138,805,1674,541,1009,264,665,498,673,292,709,1001,486,243,57,341,544,2372,0.481,0.536,0.397,0.74
1542,2023-24,Chattanooga,33,21,12,0.636,851,2039,559,1179,292,860,368,546,357,775,1132,409,216,89,343,530,2362,0.417,0.474,0.34,0.674
1543,2022-23,Chattanooga,35,18,17,0.514,888,2099,590,1206,298,893,449,586,324,861,1185,404,219,85,369,588,2523,0.423,0.489,0.334,0.766
1544,2021-22,Chattanooga,35,27,8,0.771,830,1965,594,1171,236,794,357,519,314,777,1091,375,196,121,429,513,2253,0.422,0.507,0.297,0.688
1545,2020-21,Chattanooga,26,18,8,0.692,688,1510,510,973,178,537,247,351,215,692,907,338,135,98,344,415,1801,0.456,0.524,0.331,0.704
1546,2019-20,Chattanooga,33,20,13,0.606,845,1893,627,1200,218,693,353,507,266,821,1087,387,185,103,390,554,2261,0.446,0.523,0.315,0.696
1547,2023-24,Charlotte,31,19,12,0.613,731,1714,533,1086,198,628,374,529,305,715,1020,337,178,83,311,505,2034,0.426,0.491,0.315,0.707
1548,2022-23,Charlotte,36,22,14,0.611,836,1912,590,1186,246,726,335,459,269,805,1074,347,197,98,402,490,2253,0.437,0.497,0.339,0.73
1549,2021-22,Charlotte,31,17,14,0.548,810,1758,579,1120,231,638,357,465,256,752,1008,378,174,94,350,460,2208,0.461,0.517,0.362,0.768
1550,2020-21,Charlotte,25,9,16,0.36,622,1387,447,851,175,536,249,326,196,602,798,336,173,88,311,398,1668,0.448,0.525,0.326,0.764
1551,2019-20,Charlotte,29,16,13,0.552,692,1570,492,944,200,626,293,433,219,689,908,347,201,100,398,485,1877,0.441,0.521,0.319,0.677
1552,2023-24,Charleston Southern,30,10,20,0.333,809,1795,634,1232,175,563,417,588,307,778,1085,351,187,82,285,471,2210,0.451,0.515,0.311,0.709
1553,2022-23,Charleston Southern,31,10,21,0.323,803,1747,550,1043,253,704,446,619,304,744,1048,410,172,91,350,477,2305,0.46,0.527,0.359,0.721
1554,2021-22,Charleston Southern,31,6,25,0.194,854,1839,613,1146,241,693,407,546,268,851,1119,451,242,90,389,527,2356,0.464,0.535,0.348,0.745
1555,2020-21,Charleston Southern,21,3,18,0.143,555,1252,395,786,160,466,280,425,248,546,794,275,186,79,276,368,1550,0.443,0.503,0.343,0.659
1556,2019-20,Charleston Southern,32,14,18,0.438,849,1846,621,1166,228,680,378,539,312,882,1194,452,220,86,420,504,2304,0.46,0.533,0.335,0.701
1557,2023-24,Central Michigan,32,18,14,0.563,784,1916,540,1136,244,780,430,582,366,840,1206,416,186,108,359,495,2242,0.409,0.475,0.313,0.739
1558,2022-23,Central Michigan,31,10,21,0.323,769,1757,514,1022,255,735,470,696,350,756,1106,399,257,86,415,619,2263,0.438,0.503,0.347,0.675
1559,2021-22,Central Michigan,30,7,23,0.233,802,1756,543,1012,259,744,446,634,328,813,1141,435,191,99,344,513,2309,0.457,0.537,0.348,0.703
1560,2020-21,Central Michigan,23,7,16,0.304,668,1466,467,884,201,582,298,395,260,630,890,351,144,88,320,444,1835,0.456,0.528,0.345,0.754
1561,2019-20,Central Michigan,32,14,18,0.438,893,1931,605,1170,288,761,380,534,308,901,1209,451,204,109,527,619,2454,0.462,0.517,0.378,0.712
1562,2023-24,Central Connecticut State,31,20,11,0.645,764,1809,549,1175,215,634,318,474,302,749,1051,420,209,98,396,488,2061,0.422,0.467,0.339,0.671
1563,2022-23,Central Connecticut State,32,10,22,0.313,821,1836,579,1153,242,683,361,485,302,814,1116,464,215,108,350,440,2245,0.447,0.502,0.354,0.744
1564,2021-22,Central Connecticut State,32,8,24,0.25,842,1828,592,1110,250,718,374,527,337,831,1168,444,226,120,404,489,2308,0.461,0.533,0.348,0.71
1565,2020-21,Central Connecticut State,21,5,16,0.238,592,1260,418,765,174,495,267,383,235,586,821,339,162,62,303,338,1625,0.47,0.546,0.352,0.697
1566,2019-20,Central Connecticut State,31,4,27,0.129,852,1854,582,1120,270,734,422,607,355,865,1220,473,226,131,404,503,2396,0.46,0.52,0.368,0.695
1567,2023-24,Central Arkansas,32,9,23,0.281,869,1933,567,1121,302,812,462,638,342,849,1191,418,244,100,367,504,2502,0.45,0.506,0.372,0.724
1568,2022-23,Central Arkansas,31,9,22,0.29,923,1963,644,1194,279,769,402,571,337,873,1210,432,226,105,385,451,2527,0.47,0.539,0.363,0.704
1569,2021-22,Central Arkansas,31,11,20,0.355,923,1951,675,1234,248,717,421,584,329,831,1160,486,238,105,384,442,2515,0.473,0.547,0.346,0.721
1570,2020-21,Central Arkansas,24,5,19,0.208,694,1527,476,940,218,587,327,446,245,605,850,397,224,81,285,414,1933,0.454,0.506,0.371,0.733
1571,2019-20,Central Arkansas,31,10,21,0.323,892,1989,617,1249,275,740,494,690,341,830,1171,479,291,99,432,656,2553,0.448,0.494,0.372,0.716
1572,2023-24,Canisius,32,14,18,0.438,864,1913,660,1312,204,601,375,530,321,762,1083,441,217,91,361,492,2307,0.452,0.503,0.339,0.708
1573,2022-23,Canisius,30,10,20,0.333,815,1747,612,1193,203,554,334,478,298,775,1073,400,189,96,395,473,2169,0.467,0.513,0.366,0.699
1574,2021-22,Canisius,32,11,21,0.344,844,1836,665,1251,179,585,421,579,275,890,1165,418,167,140,414,540,2288,0.46,0.532,0.306,0.727
1575,2020-21,Canisius,13,7,6,0.538,338,747,259,515,79,232,170,236,117,358,475,149,70,45,188,236,925,0.452,0.503,0.341,0.72
1576,2019-20,Canisius,32,12,20,0.375,801,1762,581,1129,220,633,443,628,309,808,1117,379,216,90,491,567,2265,0.455,0.515,0.348,0.705
1577,2023-24,Campbell,32,14,18,0.438,849,1928,574,1103,275,825,334,467,349,763,1112,439,210,104,379,533,2307,0.44,0.52,0.333,0.715
1578,2022-23,Campbell,34,16,18,0.471,834,1837,571,1074,263,763,398,573,297,787,1084,408,205,115,420,620,2329,0.454,0.532,0.345,0.695
1579,2021-22,Campbell,29,16,13,0.552,660,1546,453,945,207,601,271,415,231,703,934,304,172,84,353,451,1798,0.427,0.479,0.344,0.653
1580,2020-21,Campbell,27,17,10,0.63,673,1466,502,911,171,555,323,447,261,633,894,294,153,60,389,482,1840,0.459,0.551,0.308,0.723
1581,2019-20,Campbell,31,15,16,0.484,722,1641,552,1090,170,551,451,642,284,760,1044,312,200,65,429,463,2065,0.44,0.506,0.309,0.702
1582,2023-24,California Baptist,33,16,17,0.485,816,1855,645,1348,171,507,394,547,266,808,1074,376,194,116,336,606,2197,0.44,0.478,0.337,0.72
1583,2022-23,California Baptist,33,17,16,0.515,790,1863,605,1253,185,610,391,538,290,828,1118,365,181,86,358,596,2156,0.424,0.483,0.303,0.727
1584,2021-22,California Baptist,34,18,16,0.529,819,1974,611,1319,208,655,438,639,328,846,1174,426,213,70,418,662,2284,0.415,0.463,0.318,0.685
1585,2020-21,California Baptist,23,13,10,0.565,600,1359,443,908,157,451,317,482,213,541,754,316,147,53,275,437,1674,0.442,0.488,0.348,0.658
1586,2019-20,California Baptist,31,21,10,0.677,794,1900,605,1275,189,625,393,576,296,752,1048,385,189,105,335,604,2170,0.418,0.475,0.302,0.682
1587,2023-24,California,32,13,19,0.406,873,1949,621,1243,252,706,467,646,308,856,1164,410,189,114,336,517,2465,0.448,0.5,0.357,0.723
1588,2022-23,California,32,3,29,0.094,801,1772,574,1093,227,679,414,578,318,819,1137,413,185,130,332,526,2243,0.452,0.525,0.334,0.716
1589,2021-22,California,32,12,20,0.375,748,1778,555,1154,193,624,425,560,257,824,1081,314,186,108,307,458,2114,0.421,0.481,0.309,0.759
1590,2020-21,California,29,9,20,0.31,723,1557,533,1049,190,508,372,521,220,721,941,372,178,82,336,494,2008,0.464,0.508,0.374,0.714
1591,2019-20,California,32,14,18,0.438,748,1741,508,1080,240,661,474,644,279,782,1061,387,157,115,368,571,2210,0.43,0.47,0.363,0.736
1592,2023-24,Cal State Northridge,34,19,15,0.559,825,2037,531,1129,294,908,559,764,343,844,1187,484,271,117,455,655,2503,0.405,0.47,0.324,0.732
1593,2022-23,Cal State Northridge,32,7,25,0.219,737,1729,516,1073,221,656,499,666,322,804,1126,397,174,86,383,573,2194,0.426,0.481,0.337,0.749
1594,2021-22,Cal State Northridge,30,7,23,0.233,746,1652,535,1018,211,634,434,570,317,799,1116,431,167,80,395,491,2137,0.452,0.526,0.333,0.761
1595,2020-21,Cal State Northridge,22,9,13,0.409,601,1284,417,770,184,514,323,425,211,613,824,329,131,52,291,397,1709,0.468,0.542,0.358,0.76
1596,2019-20,Cal State Northridge,32,15,17,0.469,908,1960,603,1164,305,796,407,569,352,837,1189,491,162,101,406,583,2528,0.463,0.518,0.383,0.715
1597,2023-24,Cal State Fullerton,32,14,18,0.438,773,1790,555,1103,218,687,448,625,321,816,1137,394,199,85,402,591,2212,0.432,0.503,0.317,0.717
1598,2022-23,Cal State Fullerton,33,20,13,0.606,754,1812,534,1107,220,705,420,591,328,825,1153,372,199,97,466,633,2148,0.416,0.482,0.312,0.711
1599,2021-22,Cal State Fullerton,32,21,11,0.656,780,1772,530,1107,250,665,319,455,287,738,1025,427,197,107,444,614,2129,0.44,0.479,0.376,0.701
1600,2020-21,Cal State Fullerton,16,6,10,0.375,467,982,334,643,133,339,190,268,158,421,579,269,109,53,222,306,1257,0.476,0.519,0.392,0.709
1601,2019-20,Cal State Fullerton,31,11,20,0.355,783,1779,591,1204,192,575,455,626,279,848,1127,381,189,102,402,590,2213,0.44,0.491,0.334,0.727
1602,2023-24,Cal State Bakersfield,32,13,19,0.406,722,1675,514,1063,208,612,562,777,325,745,1070,371,184,105,422,550,2214,0.431,0.484,0.34,0.723
1603,2022-23,Cal State Bakersfield,33,11,22,0.333,700,1639,462,944,238,695,496,694,289,778,1067,373,193,81,445,510,2134,0.427,0.489,0.342,0.715
1604,2021-22,Cal State Bakersfield,28,9,19,0.321,593,1360,394,794,199,566,472,639,218,660,878,314,152,63,388,501,1857,0.436,0.496,0.352,0.739
1605,2020-21,Cal State Bakersfield,26,15,11,0.577,556,1303,373,769,183,534,370,524,209,537,746,313,151,75,369,419,1665,0.427,0.485,0.343,0.706
1606,2019-20,Cal State Bakersfield,31,12,19,0.387,666,1564,435,924,231,640,534,741,252,705,957,350,159,88,415,530,2097,0.426,0.471,0.361,0.721
1607,2023-24,Cal Poly,32,4,28,0.125,817,1778,626,1235,191,543,546,744,360,872,1232,382,207,102,380,563,2371,0.46,0.507,0.352,0.734
1608,2022-23,Cal Poly,33,8,25,0.242,732,1689,524,1079,208,610,502,695,262,807,1069,373,205,98,408,575,2174,0.433,0.486,0.341,0.722
1609,2021-22,Cal Poly,28,7,21,0.25,634,1530,435,976,199,554,418,559,260,670,930,313,174,70,328,543,1885,0.414,0.446,0.359,0.748
1610,2020-21,Cal Poly,24,4,20,0.167,597,1358,436,902,161,456,345,487,239,660,899,309,174,76,308,413,1700,0.44,0.483,0.353,0.708
1611,2019-20,Cal Poly,30,7,23,0.233,756,1668,534,1070,222,598,514,710,289,816,1105,413,195,95,402,549,2248,0.453,0.499,0.371,0.724
1612,2023-24,Butler,33,18,15,0.545,921,2094,670,1317,251,777,339,459,350,837,1187,448,240,136,380,504,2432,0.44,0.509,0.323,0.739
1613,2022-23,Butler,32,14,18,0.438,838,1874,638,1251,200,623,298,423,328,833,1161,440,219,105,400,455,2174,0.447,0.51,0.321,0.704
1614,2021-22,Butler,33,14,19,0.424,802,1848,585,1149,217,699,388,545,301,820,1121,397,187,141,373,558,2209,0.434,0.509,0.31,0.712
1615,2020-21,Butler,25,10,15,0.4,633,1362,454,850,179,512,272,388,194,654,848,345,128,92,307,418,1717,0.465,0.534,0.35,0.701
1616,2019-20,Butler,31,22,9,0.71,669,1692,457,1050,212,642,376,523,272,673,945,349,174,96,360,512,1926,0.395,0.435,0.33,0.719
1617,2023-24,Buffalo,31,4,27,0.129,913,1926,663,1238,250,688,395,553,328,812,1140,488,238,91,331,455,2471,0.474,0.536,0.363,0.714
1618,2022-23,Buffalo,32,15,17,0.469,881,1942,637,1246,244,696,479,682,322,803,1125,469,210,104,447,551,2485,0.454,0.511,0.351,0.702
1619,2021-22,Buffalo,30,19,11,0.633,797,1884,604,1274,193,610,381,541,325,717,1042,345,184,100,362,498,2168,0.423,0.474,0.316,0.704
1620,2020-21,Buffalo,25,16,9,0.64,663,1599,512,1073,151,526,346,452,265,625,890,326,161,76,327,426,1823,0.415,0.477,0.287,0.765
1621,2019-20,Buffalo,32,20,12,0.625,880,2023,661,1330,219,693,446,608,356,861,1217,413,214,121,463,571,2425,0.435,0.497,0.316,0.734
1622,2023-24,Bucknell,33,14,19,0.424,781,1831,531,1059,250,772,405,577,320,792,1112,470,210,104,353,534,2217,0.427,0.501,0.324,0.702
1623,2022-23,Bucknell,32,12,20,0.375,815,1846,578,1180,237,666,325,506,272,748,1020,453,247,100,332,472,2192,0.441,0.49,0.356,0.642
1624,2021-22,Bucknell,32,9,23,0.281,950,2038,659,1258,291,780,350,467,338,801,1139,504,271,93,306,488,2541,0.466,0.524,0.373,0.749
1625,2020-21,Bucknell,12,5,7,0.417,334,763,245,516,89,247,171,223,128,315,443,184,84,38,138,210,928,0.438,0.475,0.36,0.767
1626,2019-20,Bucknell,34,14,20,0.412,860,1865,659,1245,201,620,494,714,293,904,1197,425,234,107,471,546,2415,0.461,0.529,0.324,0.692
1627,2023-24,Bryant,33,20,13,0.606,874,2204,632,1431,242,773,498,714,425,976,1401,405,242,107,416,568,2488,0.397,0.442,0.313,0.697
1628,2022-23,Bryant,30,17,13,0.567,778,1849,541,1130,237,719,400,570,284,737,1021,433,208,88,372,540,2193,0.421,0.479,0.33,0.702
1629,2021-22,Bryant,32,22,10,0.688,879,2121,653,1409,226,712,364,530,416,816,1232,483,232,139,389,576,2348,0.414,0.463,0.317,0.687
1630,2020-21,Bryant,22,15,7,0.682,609,1480,445,910,164,570,282,400,279,570,849,325,160,81,302,420,1664,0.411,0.489,0.288,0.705
1631,2019-20,Bryant,32,15,17,0.469,803,1942,584,1236,219,706,398,586,348,842,1190,404,210,110,386,537,2223,0.413,0.472,0.31,0.679
1632,2023-24,Brown,31,13,18,0.419,801,1797,575,1110,226,687,399,573,290,783,1073,411,210,100,369,549,2227,0.446,0.518,0.329,0.696
1633,2022-23,Brown,27,14,13,0.519,689,1541,489,970,200,571,294,414,218,711,929,325,183,82,374,459,1872,0.447,0.504,0.35,0.71
1634,2021-22,Brown,29,13,16,0.448,718,1627,510,1010,208,617,371,533,271,731,1002,332,183,72,410,528,2015,0.441,0.505,0.337,0.696
1635,2019-20,Brown,27,15,12,0.556,671,1560,484,992,187,568,325,451,252,696,948,323,211,110,377,524,1854,0.43,0.488,0.329,0.721
1636,2023-24,Brigham Young,34,23,11,0.676,856,2003,638,1322,218,681,448,641,306,830,1136,405,206,80,381,520,2378,0.427,0.483,0.32,0.699
1637,2022-23,Brigham Young,34,19,15,0.559,819,1898,576,1181,243,717,495,712,282,802,1084,411,248,87,463,605,2376,0.432,0.488,0.339,0.695
1638,2021-22,Brigham Young,35,24,11,0.686,862,2055,626,1284,236,771,432,631,291,842,1133,418,214,101,375,589,2392,0.419,0.488,0.306,0.685
1639,2020-21,Brigham Young,27,20,7,0.741,669,1628,481,1058,188,570,327,480,239,638,877,312,169,54,306,500,1853,0.411,0.455,0.33,0.681
1640,2019-20,Brigham Young,32,24,8,0.75,819,1869,626,1243,193,626,357,515,266,810,1076,380,200,77,412,505,2188,0.438,0.504,0.308,0.693
1641,2023-24,Bradley,35,23,12,0.657,804,1955,559,1206,245,749,495,688,343,813,1156,398,234,72,438,539,2348,0.411,0.464,0.327,0.719
1642,2022-23,Bradley,35,25,10,0.714,760,1875,529,1150,231,725,444,592,282,825,1107,371,222,85,442,555,2195,0.405,0.46,0.319,0.75
1643,2021-22,Bradley,31,17,14,0.548,705,1740,495,1084,210,656,401,539,255,732,987,309,228,69,383,499,2021,0.405,0.457,0.32,0.744
1644,2020-21,Bradley,28,12,16,0.429,654,1570,401,887,253,683,303,457,258,686,944,361,182,59,336,395,1864,0.417,0.452,0.37,0.663
1645,2019-20,Bradley,34,23,11,0.676,765,1939,500,1100,265,839,445,592,318,820,1138,400,196,99,412,591,2240,0.395,0.455,0.316,0.752
1646,2023-24,Bowling Green,34,20,14,0.588,899,2028,645,1328,254,700,362,533,301,881,1182,421,213,125,405,610,2414,0.443,0.486,0.363,0.679
1647,2022-23,Bowling Green,31,11,20,0.355,866,1857,613,1149,253,708,449,616,298,776,1074,451,185,108,357,556,2434,0.466,0.534,0.357,0.729
1648,2021-22,Bowling Green,31,13,18,0.419,884,1974,587,1123,297,851,430,576,339,849,1188,447,196,82,408,559,2495,0.448,0.523,0.349,0.747
1649,2020-21,Bowling Green,26,14,12,0.538,703,1584,498,969,205,615,328,466,282,740,1022,347,138,99,358,440,1939,0.444,0.514,0.333,0.704
1650,2019-20,Bowling Green,31,21,10,0.677,797,1898,558,1172,239,726,426,621,314,869,1183,318,177,96,367,531,2259,0.42,0.476,0.329,0.686
1651,2023-24,Boston University,33,16,17,0.485,758,1777,511,1059,247,718,433,630,253,846,1099,381,215,97,376,520,2198,0.427,0.483,0.344,0.687
1652,2022-23,Boston University,32,15,17,0.469,749,1725,522,1049,227,676,426,618,259,818,1077,371,199,124,397,508,2151,0.434,0.498,0.336,0.689
1653,2021-22,Boston University,35,22,13,0.629,874,1942,657,1297,217,645,404,554,278,787,1065,418,244,133,389,578,2369,0.45,0.507,0.336,0.729
1654,2020-21,Boston University,18,7,11,0.389,495,1050,363,681,132,369,209,312,159,447,606,238,116,48,185,305,1331,0.471,0.533,0.358,0.67
1655,2019-20,Boston University,34,21,13,0.618,850,1946,625,1256,225,690,344,512,288,842,1130,387,219,92,395,543,2269,0.437,0.498,0.326,0.672
1656,2023-24,Boston College,36,20,16,0.556,932,2121,655,1320,277,801,446,595,333,902,1235,476,225,123,386,541,2587,0.439,0.496,0.346,0.75
1657,2022-23,Boston College,33,16,17,0.485,833,1882,559,1138,274,744,377,519,310,812,1122,408,219,109,406,505,2317,0.443,0.491,0.368,0.726
1658,2021-22,Boston College,33,13,20,0.394,797,1777,559,1124,238,653,416,560,270,820,1090,403,222,130,410,541,2248,0.449,0.497,0.364,0.743
1659,2020-21,Boston College,20,4,16,0.2,593,1208,439,773,154,435,250,351,193,550,743,297,136,68,267,347,1590,0.491,0.568,0.354,0.712
1660,2019-20,Boston College,32,13,19,0.406,818,1845,589,1159,229,686,395,552,335,885,1220,429,218,102,464,537,2260,0.443,0.508,0.334,0.716
1661,2023-24,Boise State,33,22,11,0.667,796,1818,588,1147,208,671,421,580,242,742,984,386,190,123,377,576,2221,0.438,0.513,0.31,0.726
1662,2022-23,Boise State,34,24,10,0.706,802,1933,579,1216,223,717,371,528,284,812,1096,364,176,109,401,569,2198,0.415,0.476,0.311,0.703
1663,2021-22,Boise State,35,27,8,0.771,793,1855,594,1246,199,609,345,479,244,811,1055,345,182,100,461,672,2130,0.427,0.477,0.327,0.72
1664,2020-21,Boise State,28,19,9,0.679,684,1588,502,1037,182,551,318,437,223,691,914,313,149,68,401,540,1868,0.431,0.484,0.33,0.728
1665,2019-20,Boise State,32,20,12,0.625,814,1819,602,1109,212,710,383,534,235,815,1050,365,192,74,442,641,2223,0.447,0.543,0.299,0.717
1666,2023-24,Binghamton,30,15,15,0.5,754,1790,521,1099,233,691,426,585,275,724,999,327,203,132,281,513,2167,0.421,0.474,0.337,0.728
1667,2022-23,Binghamton,31,13,18,0.419,781,1786,578,1168,203,618,452,619,305,737,1042,322,229,95,334,506,2217,0.437,0.495,0.328,0.73
1668,2021-22,Binghamton,29,12,17,0.414,721,1680,515,1055,206,625,335,502,285,738,1023,310,193,98,322,417,1983,0.429,0.488,0.33,0.667
1669,2020-21,Binghamton,18,4,14,0.222,466,1037,329,664,137,373,233,325,171,466,637,217,121,45,199,283,1302,0.449,0.495,0.367,0.717
1670,2019-20,Binghamton,29,10,19,0.345,823,1810,591,1118,232,692,343,525,330,806,1136,420,183,83,287,430,2221,0.455,0.529,0.335,0.653
1671,2023-24,Bethune-Cookman,34,17,17,0.5,806,1869,581,1200,225,669,630,886,377,836,1213,470,284,101,562,606,2467,0.431,0.484,0.336,0.711
1672,2022-23,Bethune-Cookman,32,12,20,0.375,845,1862,603,1176,242,686,469,640,368,841,1209,441,229,119,436,540,2401,0.454,0.513,0.353,0.733
1673,2021-22,Bethune-Cookman,30,9,21,0.3,735,1640,534,1026,201,614,415,563,290,758,1048,399,203,139,419,474,2086,0.448,0.52,0.327,0.737
1674,2019-20,Bethune-Cookman,30,16,14,0.533,767,1811,594,1185,173,626,460,701,347,804,1151,385,215,91,471,582,2167,0.424,0.501,0.276,0.656
1675,2023-24,Belmont,33,20,13,0.606,914,2067,645,1240,269,827,396,549,337,857,1194,492,222,97,398,541,2493,0.442,0.52,0.325,0.721
1676,2022-23,Belmont,32,21,11,0.656,852,1895,622,1250,230,645,365,547,334,793,1127,420,184,111,406,478,2299,0.45,0.498,0.357,0.667
1677,2021-22,Belmont,33,25,8,0.758,838,1948,573,1172,265,776,323,457,323,785,1108,441,221,112,493,478,2264,0.43,0.489,0.341,0.707
1678,2020-21,Belmont,30,26,4,0.867,773,1813,550,1153,223,660,305,448,307,747,1054,386,189,110,441,489,2074,0.426,0.477,0.338,0.681
1679,2019-20,Belmont,33,26,7,0.788,846,2033,614,1329,232,704,317,495,336,874,1210,398,191,97,473,478,2241,0.416,0.462,0.33,0.64
1680,2023-24,Bellarmine,31,8,23,0.258,818,1813,539,1013,279,800,405,551,298,837,1135,416,145,94,315,423,2320,0.451,0.532,0.349,0.735
1681,2022-23,Bellarmine,33,15,18,0.455,763,1717,448,828,315,889,375,520,276,763,1039,448,179,67,394,491,2216,0.444,0.541,0.354,0.721
1682,2021-22,Bellarmine,33,20,13,0.606,789,1790,506,955,283,835,356,502,298,773,1071,411,164,72,389,482,2217,0.441,0.53,0.339,0.709
1683,2020-21,Bellarmine,22,14,8,0.636,514,1142,310,601,204,541,224,318,179,466,645,292,117,62,332,349,1456,0.45,0.516,0.377,0.704
1684,2023-24,Baylor,35,24,11,0.686,904,1987,666,1279,238,708,443,603,308,715,1023,479,244,120,414,665,2489,0.455,0.521,0.336,0.735
1685,2022-23,Baylor,34,23,11,0.676,864,1902,630,1182,234,720,427,595,341,745,1086,518,208,97,460,624,2389,0.454,0.533,0.325,0.718
1686,2021-22,Baylor,34,27,7,0.794,801,1892,594,1207,207,685,369,525,335,766,1101,448,219,95,539,569,2178,0.423,0.492,0.302,0.703
1687,2020-21,Baylor,30,28,2,0.933,711,1642,526,1079,185,563,357,514,298,653,951,368,167,123,510,493,1964,0.433,0.487,0.329,0.695
1688,2019-20,Baylor,30,26,4,0.867,643,1618,467,1052,176,566,342,498,306,696,1002,339,174,146,456,549,1804,0.397,0.444,0.311,0.687
1689,2023-24,Ball State,31,15,16,0.484,811,1821,591,1178,220,643,358,505,298,746,1044,383,196,95,369,591,2200,0.445,0.502,0.342,0.709
1690,2022-23,Ball State,32,20,12,0.625,823,1873,586,1254,237,619,409,561,311,743,1054,306,198,79,373,650,2292,0.439,0.467,0.383,0.729
1691,2021-22,Ball State,31,14,17,0.452,830,1865,543,1069,287,796,433,603,312,809,1121,413,229,90,385,611,2380,0.445,0.508,0.361,0.718
1692,2020-21,Ball State,23,10,13,0.435,611,1419,444,881,167,538,347,506,272,595,867,288,168,60,288,409,1736,0.431,0.504,0.31,0.686
1693,2019-20,Ball State,31,18,13,0.581,708,1766,526,1173,182,593,340,496,275,801,1076,305,197,82,422,507,1938,0.401,0.448,0.307,0.685
1694,2023-24,Austin Peay,35,19,16,0.543,910,1967,680,1254,230,713,511,721,360,881,1241,423,151,119,400,557,2561,0.463,0.542,0.323,0.709
1695,2022-23,Austin Peay,31,9,22,0.29,796,1664,594,1071,202,593,447,604,291,801,1092,427,192,80,421,480,2241,0.478,0.555,0.341,0.74
1696,2021-22,Austin Peay,29,12,17,0.414,720,1547,523,962,197,585,367,535,277,730,1007,388,204,101,414,477,2004,0.465,0.544,0.337,0.686
1697,2020-21,Austin Peay,27,14,13,0.519,687,1457,493,916,194,541,322,477,249,607,856,312,210,70,436,489,1890,0.472,0.538,0.359,0.675
1698,2019-20,Austin Peay,33,21,12,0.636,861,1841,635,1215,226,626,411,594,303,790,1093,448,201,80,493,643,2359,0.468,0.523,0.361,0.692
1699,2023-24,Auburn,35,27,8,0.771,784,2029,579,1351,205,678,618,842,403,803,1206,335,233,113,449,665,2391,0.386,0.429,0.302,0.734
1700,2022-23,Auburn,34,21,13,0.618,788,1935,596,1268,192,667,534,752,401,810,1211,380,238,118,442,610,2302,0.407,0.47,0.288,0.71
1701,2021-22,Auburn,34,28,6,0.824,777,2014,552,1289,225,725,506,690,382,860,1242,382,255,131,493,596,2285,0.386,0.428,0.31,0.733
1702,2020-21,Auburn,27,13,14,0.481,748,1708,550,1102,198,606,370,540,329,651,980,340,236,101,369,535,2064,0.438,0.499,0.327,0.685
1703,2019-20,Auburn,31,25,6,0.806,759,1840,542,1173,217,667,447,623,319,771,1090,346,207,97,418,656,2182,0.413,0.462,0.325,0.717
1704,2023-24,Army,32,10,22,0.313,734,1712,513,1033,221,679,370,526,266,820,1086,413,224,95,348,478,2059,0.429,0.497,0.325,0.703
1705,2022-23,Army,33,17,16,0.515,852,1909,609,1176,243,733,375,539,262,740,1002,448,227,102,356,533,2322,0.446,0.518,0.332,0.696
1706,2021-22,Army,31,15,16,0.484,819,1854,553,1104,266,750,278,415,291,803,1094,445,236,130,430,525,2182,0.442,0.501,0.355,0.67
1707,2020-21,Army,22,12,10,0.545,560,1276,376,758,184,518,225,310,185,590,775,283,154,74,303,375,1529,0.439,0.496,0.355,0.726
1708,2019-20,Army,30,15,15,0.5,801,1821,534,1063,267,758,292,436,271,802,1073,411,189,101,356,442,2161,0.44,0.502,0.352,0.67
1709,2023-24,Arkansas–Pine Bluff,31,13,18,0.419,915,2011,681,1243,234,768,472,657,374,814,1188,510,222,104,362,561,2536,0.455,0.548,0.305,0.718
1710,2022-23,Arkansas–Pine Bluff,31,10,21,0.323,738,1689,541,1086,197,603,489,695,287,840,1127,437,262,105,497,523,2162,0.437,0.498,0.327,0.704
1711,2021-22,Arkansas–Pine Bluff,31,7,24,0.226,894,1807,693,1249,201,558,437,600,342,832,1174,482,233,107,412,526,2426,0.495,0.555,0.36,0.728
1712,2020-21,Arkansas–Pine Bluff,25,4,21,0.16,680,1434,489,956,191,478,370,549,263,659,922,404,207,95,322,472,1921,0.474,0.512,0.4,0.674
1713,2019-20,Arkansas–Pine Bluff,30,4,26,0.133,681,1577,499,988,182,589,505,744,291,690,981,387,289,76,425,523,2049,0.432,0.505,0.309,0.679
1714,2023-24,Arkansas State,37,20,17,0.541,1023,2234,811,1632,212,602,592,778,377,927,1304,414,258,158,369,610,2850,0.458,0.497,0.352,0.761
1715,2022-23,Arkansas State,33,13,20,0.394,778,1776,559,1180,219,596,457,615,298,795,1093,378,199,112,382,549,2232,0.438,0.474,0.367,0.743
1716,2021-22,Arkansas State,29,18,11,0.621,722,1685,538,1126,184,559,346,493,291,692,983,342,206,93,399,500,1974,0.428,0.478,0.329,0.702
1717,2020-21,Arkansas State,24,11,13,0.458,608,1431,448,952,160,479,291,393,239,567,806,294,163,101,301,425,1667,0.425,0.471,0.334,0.74
1718,2019-20,Arkansas State,32,16,16,0.5,787,1725,579,1120,208,605,519,716,300,782,1082,437,193,67,449,668,2301,0.456,0.517,0.344,0.725
1719,2023-24,Arkansas,33,16,17,0.485,909,2039,673,1343,236,696,579,796,366,834,1200,428,213,96,365,685,2633,0.446,0.501,0.339,0.727
1720,2022-23,Arkansas,36,22,14,0.611,847,1996,658,1388,189,608,563,788,348,841,1189,382,241,103,519,681,2446,0.424,0.474,0.311,0.714
1721,2021-22,Arkansas,37,28,9,0.757,880,2135,611,1306,269,829,498,681,336,955,1291,464,244,128,549,721,2527,0.412,0.468,0.324,0.731
1722,2020-21,Arkansas,32,25,7,0.781,813,1958,565,1220,248,738,390,568,313,831,1144,393,209,116,483,607,2264,0.415,0.463,0.336,0.687
1723,2019-20,Arkansas,32,20,12,0.625,773,1808,609,1206,164,602,518,739,351,875,1226,324,160,95,512,687,2228,0.428,0.505,0.272,0.701
1724,2023-24,Arizona State,32,14,18,0.438,850,1887,599,1147,251,740,417,589,338,960,1298,490,186,85,439,535,2368,0.45,0.522,0.339,0.708
1725,2022-23,Arizona State,36,23,13,0.639,836,2096,557,1278,279,818,496,702,423,959,1382,458,219,107,505,652,2447,0.399,0.436,0.341,0.707
1726,2021-22,Arizona State,31,14,17,0.452,718,1797,489,1060,229,737,419,581,352,882,1234,412,190,97,419,471,2084,0.4,0.461,0.311,0.721
1727,2020-21,Arizona State,25,11,14,0.44,671,1460,479,930,192,530,393,527,257,733,990,373,139,80,380,455,1927,0.46,0.515,0.362,0.746
1728,2019-20,Arizona State,31,20,11,0.645,769,1796,542,1110,227,686,419,615,318,864,1182,388,203,119,508,569,2184,0.428,0.488,0.331,0.681
1729,2023-24,Arizona,36,27,9,0.75,949,2252,668,1399,281,853,415,583,323,852,1175,496,250,132,483,684,2594,0.421,0.477,0.329,0.712
1730,2022-23,Arizona,35,28,7,0.8,905,2216,628,1358,277,858,403,565,360,803,1163,443,276,122,431,671,2490,0.408,0.462,0.323,0.713
1731,2021-22,Arizona,37,33,4,0.892,928,2400,655,1567,273,833,389,577,441,810,1251,438,257,107,472,696,2518,0.387,0.418,0.328,0.674
1732,2020-21,Arizona,26,17,9,0.654,631,1470,447,931,184,539,337,477,220,592,812,292,140,72,322,524,1783,0.429,0.48,0.341,0.706
1733,2019-20,Arizona,32,21,11,0.656,708,1797,497,1120,211,677,463,632,296,787,1083,363,155,99,465,614,2090,0.394,0.444,0.312,0.733
1734,2023-24,Appalachian State,34,27,7,0.794,865,2225,639,1493,226,732,327,472,393,843,1236,349,234,84,356,556,2283,0.389,0.428,0.309,0.693
1735,2022-23,Appalachian State,32,16,16,0.5,753,1870,518,1141,235,729,326,456,322,830,1152,378,192,76,399,512,2067,0.403,0.454,0.322,0.715
1736,2021-22,Appalachian State,34,19,15,0.559,806,1924,579,1190,227,734,307,407,288,891,1179,448,177,105,407,518,2146,0.419,0.487,0.309,0.754
1737,2020-21,Appalachian State,29,17,12,0.586,689,1648,487,1026,202,622,280,394,269,751,1020,346,164,125,405,507,1860,0.418,0.475,0.325,0.711
1738,2019-20,Appalachian State,33,18,15,0.545,813,1886,572,1140,241,746,355,494,322,844,1166,447,225,86,476,645,2222,0.431,0.502,0.323,0.719
1739,2023-24,American,32,16,16,0.5,776,1706,504,973,272,733,352,508,255,724,979,403,160,78,345,515,2176,0.455,0.518,0.371,0.693
1740,2022-23,American,32,17,15,0.531,754,1665,538,1104,216,561,386,534,275,656,931,394,264,75,390,486,2110,0.453,0.487,0.385,0.723
1741,2021-22,American,32,10,22,0.313,849,1794,636,1180,213,614,359,519,250,809,1059,433,216,103,367,455,2270,0.473,0.539,0.347,0.692
1742,2020-21,American,10,4,6,0.4,268,584,218,412,50,172,150,224,106,245,351,117,85,25,125,156,736,0.459,0.529,0.291,0.67
1743,2019-20,American,30,16,14,0.533,745,1668,577,1142,168,526,427,612,296,742,1038,356,179,96,411,472,2085,0.447,0.505,0.319,0.698
1744,2023-24,Alcorn State,32,14,18,0.438,841,1818,530,990,311,828,484,666,316,712,1028,500,203,129,378,572,2477,0.463,0.535,0.376,0.727
1745,2022-23,Alcorn State,32,18,14,0.563,778,1741,545,1034,233,707,470,683,322,755,1077,458,183,109,463,565,2259,0.447,0.527,0.33,0.688
1746,2021-22,Alcorn State,34,17,17,0.5,844,1892,612,1217,232,675,497,694,316,852,1168,471,234,138,450,582,2417,0.446,0.503,0.344,0.716
1747,2020-21,Alcorn State,19,6,13,0.316,483,992,349,605,134,387,337,497,175,488,663,280,128,79,299,338,1437,0.487,0.577,0.346,0.678
1748,2019-20,Alcorn State,30,15,15,0.5,795,1770,595,1164,200,606,406,632,296,762,1058,420,222,89,413,509,2196,0.449,0.511,0.33,0.642
1749,2023-24,Albany (NY),32,13,19,0.406,907,1944,740,1368,167,576,540,744,323,829,1152,420,235,149,415,499,2521,0.467,0.541,0.29,0.726
1750,2022-23,Albany (NY),31,8,23,0.258,836,1704,635,1133,201,571,459,630,256,784,1040,450,203,111,364,507,2332,0.491,0.56,0.352,0.729
1751,2021-22,Albany (NY),31,13,18,0.419,720,1641,495,1008,225,633,377,522,265,794,1059,388,163,135,423,462,2042,0.439,0.491,0.355,0.722
1752,2020-21,Albany (NY),16,7,9,0.438,402,894,288,564,114,330,181,262,139,383,522,196,90,64,233,295,1099,0.45,0.511,0.345,0.691
1753,2019-20,Albany (NY),32,14,18,0.438,788,1876,537,1144,251,732,363,523,287,817,1104,430,246,109,409,574,2190,0.42,0.469,0.343,0.694
1754,2023-24,Alabama State,32,13,19,0.406,721,1751,476,1025,245,726,534,736,317,943,1260,385,196,152,468,514,2221,0.412,0.464,0.337,0.726
1755,2022-23,Alabama State,31,8,23,0.258,801,1839,585,1204,216,635,434,632,375,809,1184,367,218,153,379,513,2252,0.436,0.486,0.34,0.687
1756,2021-22,Alabama State,31,10,21,0.323,822,1863,591,1160,231,703,457,632,364,772,1136,441,239,120,437,554,2332,0.441,0.509,0.329,0.723
1757,2020-21,Alabama State,18,4,14,0.222,456,1042,348,710,108,332,268,385,188,489,677,227,139,75,268,388,1288,0.438,0.49,0.325,0.696
1758,2019-20,Alabama State,32,8,24,0.25,812,1781,610,1168,202,613,447,683,309,851,1160,408,238,115,459,624,2273,0.456,0.522,0.33,0.654
1759,2023-24,Alabama A&M,35,12,23,0.343,856,2010,595,1268,261,742,680,908,415,843,1258,463,331,114,492,701,2653,0.426,0.469,0.352,0.749
1760,2022-23,Alabama A&M,33,15,18,0.455,781,1842,530,1107,251,735,527,743,399,780,1179,420,258,115,510,581,2340,0.424,0.479,0.341,0.709
1761,2021-22,Alabama A&M,30,12,18,0.4,718,1791,495,1095,223,696,351,513,358,830,1188,405,226,86,408,507,2010,0.401,0.452,0.32,0.684
1762,2020-21,Alabama A&M,15,6,9,0.4,350,891,266,594,84,297,224,333,172,410,582,188,121,40,192,251,1008,0.393,0.448,0.283,0.673
1763,2019-20,Alabama A&M,30,8,22,0.267,778,1705,585,1110,193,595,397,600,275,871,1146,399,198,131,381,530,2146,0.456,0.527,0.324,0.662
1764,2023-24,Alabama,37,25,12,0.676,1028,2351,751,1478,277,873,673,912,446,878,1324,472,273,163,418,739,3006,0.437,0.508,0.317,0.738
1765,2022-23,Alabama,37,31,6,0.838,885,2387,683,1672,202,715,554,779,452,931,1383,364,268,142,434,737,2526,0.371,0.408,0.283,0.711
1766,2021-22,Alabama,33,19,14,0.576,887,2028,642,1303,245,725,504,705,379,811,1190,411,258,123,435,602,2523,0.437,0.493,0.338,0.715
1767,2020-21,Alabama,33,26,7,0.788,837,2053,632,1349,205,704,434,630,378,876,1254,368,261,161,506,599,2313,0.408,0.468,0.291,0.689
1768,2019-20,Alabama,31,16,15,0.516,850,2002,633,1307,217,695,532,718,382,851,1233,369,263,124,435,629,2449,0.425,0.484,0.312,0.741
1769,2023-24,Akron,35,24,11,0.686,853,1985,629,1247,224,738,386,561,309,825,1134,391,205,87,404,599,2316,0.43,0.504,0.304,0.688
1770,2022-23,Akron,33,22,11,0.667,802,1873,573,1204,229,669,376,512,296,785,1081,370,190,99,407,608,2209,0.428,0.476,0.342,0.734
1771,2021-22,Akron,34,24,10,0.706,783,1857,558,1199,225,658,339,480,295,758,1053,321,187,77,400,643,2130,0.422,0.465,0.342,0.706
1772,2020-21,Akron,23,15,8,0.652,621,1435,470,949,151,486,267,375,253,584,837,279,129,51,274,422,1660,0.433,0.495,0.311,0.712
1773,2019-20,Akron,31,24,7,0.774,754,1886,561,1250,193,636,361,540,355,782,1137,318,187,85,410,618,2062,0.4,0.449,0.303,0.669
1774,2023-24,Air Force,31,9,22,0.29,774,1631,555,1033,219,598,476,637,297,719,1016,386,178,96,348,495,2243,0.475,0.537,0.366,0.747
1775,2022-23,Air Force,32,14,18,0.438,764,1718,598,1152,166,566,452,604,293,743,1036,323,183,99,352,545,2146,0.445,0.519,0.293,0.748
1776,2021-22,Air Force,29,11,18,0.379,669,1445,519,964,150,481,427,562,249,707,956,317,156,97,373,487,1915,0.463,0.538,0.312,0.76
1777,2020-21,Air Force,25,5,20,0.2,654,1309,460,779,194,530,296,430,258,607,865,368,150,53,348,418,1798,0.5,0.591,0.366,0.688
1778,2019-20,Air Force,32,12,20,0.375,839,1809,508,926,331,883,377,530,232,808,1040,462,200,88,366,605,2386,0.464,0.549,0.375,0.711
1779,2023-24,Abilene Christian,34,16,18,0.471,888,1923,689,1310,199,613,525,766,342,909,1251,420,227,113,495,642,2500,0.462,0.526,0.325,0.685
1780,2022-23,Abilene Christian,30,13,17,0.433,727,1526,539,1009,188,517,491,687,240,768,1008,374,167,98,530,573,2133,0.476,0.534,0.364,0.715
1781,2021-22,Abilene Christian,36,25,11,0.694,782,1781,540,1060,242,721,626,863,327,914,1241,403,199,130,755,764,2432,0.439,0.509,0.336,0.725
1782,2020-21,Abilene Christian,29,24,5,0.828,601,1488,440,968,161,520,390,573,263,722,985,299,189,110,578,580,1753,0.404,0.455,0.31,0.681
1783,2019-20,Abilene Christian,31,20,11,0.645,668,1545,514,1028,154,517,534,728,271,765,1036,297,211,114,616,616,2024,0.432,0.5,0.298,0.734
